0_TA_TacticalIntro:	Title='', Desc=''
1_TA_ProdTeam:	Title='', Desc=''
10_Ext_Comm:	Title='', Desc=''
11_Ext_3DProd:	Title='', Desc=''
12_Ext_Anim:	Title='', Desc=''
13_Ext_Sound:	Title='', Desc=''
14_Ext_UIUX:	Title='', Desc=''
15_Realityz:	Title='', Desc=''
16_SpecialThanks:	Title='', Desc=''
17_Ext_Tech:	Title='', Desc=''
18_Ext_Loca:	Title='', Desc=''
19_Pets:	Title='', Desc=''
2_TA_ArtTeam:	Title='', Desc=''
20_Baby:	Title='', Desc=''
21_BackersDesign:	Title='', Desc=''
3_TA_ProgTeam:	Title='', Desc=''
4_TA_DesignTeam:	Title='', Desc=''
5_TA_NarrationTeam:	Title='', Desc=''
6_TA_MarketTeam:	Title='', Desc=''
7_TA_AdminTeam:	Title='', Desc=''
8_Ext_ConceptArt:	Title='', Desc=''
9_Ext_QA:	Title='', Desc=''
Abjuration_00_EmtansChest:	Title='Campaign/&CrownOfTheMagister_Journal_Abjuration_00', Desc=''
Abjuration_00_FindMausoleum:	Title='Campaign/&CrownOfTheMagister_Journal_Abjuration_00', Desc=''
Abjuration_01_MeetKythaela:	Title='Campaign/&CrownOfTheMagister_Journal_Abjuration_01', Desc=''
Abjuration_02_Caravan:	Title='Campaign/&CrownOfTheMagister_Journal_Abjuration_02', Desc=''
Abjuration_03_MeetNikannen1:	Title='Campaign/&CrownOfTheMagister_Journal_Abjuration_03', Desc=''
Abjuration_04_Ceannard_01:	Title='Campaign/&CrownOfTheMagister_Journal_Abjuration_04', Desc=''
Abjuration_05_Tavern_01:	Title='Campaign/&CrownOfTheMagister_Journal_Abjuration_05', Desc=''
Abjuration_06_Tavern_02:	Title='Campaign/&CrownOfTheMagister_Journal_Abjuration_06', Desc=''
Abjuration_07_Tavern_03:	Title='Campaign/&CrownOfTheMagister_Journal_Abjuration_07', Desc=''
Abjuration_08_Tavern_04:	Title='Campaign/&CrownOfTheMagister_Journal_Abjuration_08', Desc=''
Abjuration_09_GeneralStore:	Title='Campaign/&CrownOfTheMagister_Journal_Abjuration_09', Desc=''
Abjuration_09_GeneralStoreBaronSaved:	Title='Campaign/&CrownOfTheMagister_Journal_Abjuration_09', Desc=''
Abjuration_10_MeetNikannen2:	Title='Campaign/&CrownOfTheMagister_Journal_Abjuration_10', Desc=''
Abjuration_11_MeetBaron1:	Title='Campaign/&CrownOfTheMagister_Journal_Abjuration_11', Desc=''
Abjuration_12_MeetNikannen3:	Title='Campaign/&CrownOfTheMagister_Journal_Abjuration_12', Desc=''
Abjuration_13_MeetBaron2:	Title='Campaign/&CrownOfTheMagister_Journal_Abjuration_13', Desc=''
Abjuration_14_Basement:	Title='Campaign/&CrownOfTheMagister_Journal_Abjuration_14', Desc=''
Abjuration_14_Basement_AfterBattle:	Title='Campaign/&CrownOfTheMagister_Journal_Abjuration_14_b', Desc=''
Abjuration_14_Basement_Heirlooms:	Title='Campaign/&CrownOfTheMagister_Journal_Abjuration_14_c', Desc=''
Abjuration_14_Basement_Teleporter:	Title='Campaign/&CrownOfTheMagister_Journal_Abjuration_14_d', Desc=''
Abjuration_15_Basement_OptionalPuzzleFiller:	Title='', Desc=''
Abjuration_16_SavedBaron:	Title='Campaign/&CrownOfTheMagister_Journal_Abjuration_16', Desc=''
Abjuration_17_AbjurationTower_FindBuilding:	Title='Campaign/&CrownOfTheMagister_Journal_Abjuration_17', Desc=''
Abjuration_18_AbjurationTower_StartFight:	Title='Campaign/&CrownOfTheMagister_Journal_Abjuration_18', Desc=''
Abjuration_19_FindingAdrasteia:	Title='Campaign/&CrownOfTheMagister_Journal_Abjuration_19', Desc=''
Abjuration_19_FindingAdrasteia_NEW:	Title='Campaign/&CrownOfTheMagister_Journal_Abjuration_19', Desc=''
Abjuration_20_Finale:	Title='', Desc=''
Abjuration_21_Encounter_Bridge:	Title='Campaign/&CrownOfTheMagister_Journal_Abjuration_21', Desc=''
Abjuration_22_Encounter_Prison:	Title='Campaign/&CrownOfTheMagister_Journal_Abjuration_22', Desc=''
Abjuration_23_Tavern_Mildred:	Title='Campaign/&CrownOfTheMagister_Journal_Abjuration_23', Desc=''
Abjuration_23_Tavern_MildredBaronSaved:	Title='Campaign/&CrownOfTheMagister_Journal_Abjuration_23', Desc=''
Abjuration_24_WizardTower_MistyFormEscape_Entrance:	Title='', Desc=''
Abjuration_Coparann_DateTime_DEBUG:	Title='', Desc=''
Abjuration_Monastery_DateTime:	Title='', Desc=''
Abjuration_Quest:	Title='Quest/&Monastery_Title', Desc=''
Abjuration_Scenario:	Title='Abjuration', Desc=''
Abjuration_WizardTower_DateTime_01h00:	Title='', Desc=''
Abjuration_WizardTower_DateTime_17h30:	Title='', Desc=''
AbjurationTower:	Title='', Desc=''
AcademicMasterDackinCompatibilityScenario:	Title='', Desc=''
Acid:	Title='VisualMood/&AcidTitle', Desc=''
Acknowledgements:	Title='', Desc=''
Act3_AerElai_01:	Title='Campaign/&CrownOfTheMagister_Journal_DialogTitle_Act3_AerElai_01', Desc=''
Act3_AerElai_02:	Title='Campaign/&CrownOfTheMagister_Journal_DialogTitle_Act3_AerElai_02', Desc=''
Act3_AerElai_03:	Title='Campaign/&CrownOfTheMagister_Journal_DialogTitle_Act3_AerElai_03', Desc=''
Act3_AerElai_04:	Title='Campaign/&CrownOfTheMagister_Journal_DialogTitle_Act3_AerElai_04', Desc=''
Act3_AerElai_05:	Title='Campaign/&CrownOfTheMagister_Journal_DialogTitle_Act3_AerElai_05', Desc=''
Act3_AerElai_06:	Title='Campaign/&CrownOfTheMagister_Journal_DialogTitle_Act3_AerElai_06', Desc=''
Act3_AerElai_07:	Title='Campaign/&CrownOfTheMagister_Journal_DialogTitle_Act3_AerElai_07', Desc=''
Act3_AerElai_08:	Title='Campaign/&CrownOfTheMagister_Journal_DialogTitle_Act3_AerElai_08', Desc=''
Act3_AerElai_09:	Title='Campaign/&CrownOfTheMagister_Journal_DialogTitle_Act3_AerElai_09', Desc=''
Act3_AerElai_09_OneDragon:	Title='Campaign/&CrownOfTheMagister_Journal_DialogTitle_Act3_AerElai_10', Desc=''
Act3_AerElai_09_ZeroDragon:	Title='Campaign/&CrownOfTheMagister_Journal_DialogTitle_Act3_AerElai_10', Desc=''
Act3_AerElai_10:	Title='Campaign/&CrownOfTheMagister_Journal_DialogTitle_Act3_AerElai_10', Desc=''
Act3_AerElai_Dragon_Fight_01:	Title='', Desc=''
Act3_AerElai_Dragon_Fight_02:	Title='', Desc=''
Act3_AerElai_LavaTravel:	Title='', Desc=''
ActivatorMechanism:	Title='Gadget/&MechanismTitle', Desc=''
Adria_CombatDecisions:	Title='', Desc=''
AdventureLog:	Title='', Desc=''
Aer_Elai_Final_Quest:	Title='Quest/&Aer_Elai_Final_Quest_Title', Desc=''
Aer_Elai_Final_Scenario:	Title='AER ELAI FINAL', Desc=''
Aer_Elai_Scenario_Flashback:	Title='AER ELAI FLASHBACK LAUNCHED AFTER COUNCIL 02 CUTSCENE E', Desc=''
AerElaiRuins:	Title='', Desc=''
After_Council_01_Talk_To_Gormsdottir:	Title='', Desc=''
AirElementalCombatDecisions:	Title='', Desc=''
Albinos_Minotaur_Presentation:	Title='', Desc=''
AlchemyTable:	Title='Prop/&AlchemyTableTitle', Desc=''
Altar_A:	Title='Prop/&AltarTitle', Desc=''
Altar_B:	Title='Prop/&AltarTitle', Desc=''
Altar_C:	Title='Prop/&AltarTitle', Desc=''
Altar_D:	Title='Prop/&AltarTitle', Desc=''
Altar_E:	Title='Prop/&AltarTitle', Desc=''
Arch_A:	Title='Prop/&ArchTitle', Desc=''
Arch_B:	Title='Prop/&ArchTitle', Desc=''
Arch_C:	Title='Prop/&ArchTitle', Desc=''
Arch_D:	Title='Prop/&ArchTitle', Desc=''
ArmorStandProp:	Title='Prop/&ArmorStandTitle', Desc=''
ArwinMerton_FixBringswordCS:	Title='', Desc=''
ArwinMertonFirstScavenger02CompatibilityScenario:	Title='', Desc=''
ArwinMertonSwordCompatibilityScenario:	Title='', Desc=''
AttributeModifierArmor_Arcane_Shieldstaff:	Title='', Desc='Feature/&AttributeModifierACPlus1Description'
AttributeModifierArmor_ChildOfDarkness_Force13+1:	Title='', Desc='Feature/&AttributeModifierACPlus1Description'
AttributeModifierArmor_ChildOfDarkness_Force14+1:	Title='', Desc='Feature/&AttributeModifierACPlus1Description'
AttributeModifierArmor_ChildOfDarkness_Force14+2:	Title='', Desc='Feature/&AttributeModifierACPlus2Description'
AttributeModifierArmor_ChildOfDarkness_Force15+1:	Title='', Desc='Feature/&AttributeModifierACPlus1Description'
AttributeModifierArmor_ChildOfDarkness_Force15+2:	Title='', Desc='Feature/&AttributeModifierACPlus2Description'
AttributeModifierArmor_ChildOfDarkness_Force16+2:	Title='', Desc='Feature/&AttributeModifierACPlus2Description'
AttributeModifierArmor_ChildOfDarkness_Force16+3:	Title='', Desc='Feature/&AttributeModifierACPlus3Description'
AttributeModifierArmor_ChildOfDarkness_Force18+2:	Title='', Desc='Feature/&AttributeModifierACPlus2Description'
AttributeModifierArmor_ChildOfDarkness_Force18+3:	Title='', Desc='Feature/&AttributeModifierACPlus3Description'
AttributeModifierArmor+1:	Title='', Desc='Feature/&AttributeModifierACPlus1Description'
AttributeModifierArmor+2:	Title='', Desc='Feature/&AttributeModifierACPlus2Description'
AttributeModifierArmor+3:	Title='', Desc='Feature/&AttributeModifierACPlus3Description'
AttributeModifierGiantHillPermanent:	Title='Feature/&NoContentTitle', Desc=''
AuthorizeEncountersCompatibilityScenario:	Title='', Desc=''
Background_Quest_Academic_01:	Title='Campaign/&CrownOfTheMagister_Journal_DialogTitle_Background_Quest_Academic_01', Desc=''
Background_Quest_Academic_02:	Title='Campaign/&CrownOfTheMagister_Journal_DialogTitle_Background_Quest_Academic_02', Desc=''
Background_Quest_Academic_02b:	Title='Campaign/&CrownOfTheMagister_Journal_DialogTitle_Background_Quest_Academic_02', Desc=''
Background_Quest_Academic_03:	Title='Campaign/&CrownOfTheMagister_Journal_DialogTitle_Background_Quest_Academic_03', Desc=''
Background_Quest_Academic_04:	Title='Campaign/&CrownOfTheMagister_Journal_DialogTitle_Background_Quest_Academic_04', Desc=''
Background_Quest_Academic_05:	Title='Campaign/&CrownOfTheMagister_Journal_DialogTitle_Background_Quest_Academic_05', Desc=''
Background_Quest_Academic_06:	Title='Campaign/&CrownOfTheMagister_Journal_DialogTitle_Background_Quest_Academic_06', Desc=''
Background_Quest_Academic_07:	Title='Campaign/&CrownOfTheMagister_Journal_DialogTitle_Background_Quest_Academic_07', Desc=''
Background_Quest_Acolyte_01:	Title='Campaign/&CrownOfTheMagister_Journal_DialogTitle_Background_Quest_Acolyte_01', Desc=''
Background_Quest_Acolyte_02:	Title='Campaign/&CrownOfTheMagister_Journal_DialogTitle_Background_Quest_Acolyte_02', Desc=''
Background_Quest_Acolyte_03:	Title='Campaign/&CrownOfTheMagister_Journal_DialogTitle_Background_Quest_Acolyte_03', Desc=''
Background_Quest_Acolyte_04:	Title='Campaign/&CrownOfTheMagister_Journal_DialogTitle_Background_Quest_Acolyte_04', Desc=''
Background_Quest_Acolyte_05:	Title='Campaign/&CrownOfTheMagister_Journal_DialogTitle_Background_Quest_Acolyte_05', Desc=''
Background_Quest_Aristocrat_01:	Title='Campaign/&CrownOfTheMagister_Journal_DialogTitle_Background_Quest_Aristocrat_01', Desc=''
Background_Quest_Aristocrat_02:	Title='Campaign/&CrownOfTheMagister_Journal_DialogTitle_Background_Quest_Aristocrat_02', Desc=''
Background_Quest_Aristocrat_03:	Title='Campaign/&CrownOfTheMagister_Journal_DialogTitle_Background_Quest_Aristocrat_03', Desc=''
Background_Quest_Aristocrat_04:	Title='Campaign/&CrownOfTheMagister_Journal_DialogTitle_Background_Quest_Aristocrat_04', Desc=''
Background_Quest_Aristocrat_05:	Title='Campaign/&CrownOfTheMagister_Journal_DialogTitle_Background_Quest_Aristocrat_05', Desc=''
Background_Quest_Aristocrat_06:	Title='Campaign/&CrownOfTheMagister_Journal_DialogTitle_Background_Quest_Aristocrat_06', Desc=''
Background_Quest_Aristocrat_07:	Title='Campaign/&CrownOfTheMagister_Journal_DialogTitle_Background_Quest_Aristocrat_07', Desc=''
Background_Quest_Lawkeeper_01:	Title='Campaign/&CrownOfTheMagister_Journal_DialogTitle_Background_Quest_Lawkeeper_01', Desc=''
Background_Quest_Lawkeeper_02:	Title='Campaign/&CrownOfTheMagister_Journal_DialogTitle_Background_Quest_Lawkeeper_02', Desc=''
Background_Quest_Lawkeeper_03A:	Title='Campaign/&CrownOfTheMagister_Journal_DialogTitle_Background_Quest_Lawkeeper_03A', Desc=''
Background_Quest_Lawkeeper_03B:	Title='Campaign/&CrownOfTheMagister_Journal_DialogTitle_Background_Quest_Lawkeeper_03B', Desc=''
Background_Quest_Lawkeeper_04A:	Title='Campaign/&CrownOfTheMagister_Journal_DialogTitle_Background_Quest_Lawkeeper_04A', Desc=''
Background_Quest_Lawkeeper_04B:	Title='Campaign/&CrownOfTheMagister_Journal_DialogTitle_Background_Quest_Lawkeeper_04B', Desc=''
Background_Quest_Lawkeeper_05A:	Title='Campaign/&CrownOfTheMagister_Journal_DialogTitle_Background_Quest_Lawkeeper_05A', Desc=''
Background_Quest_Lawkeeper_05B:	Title='Campaign/&CrownOfTheMagister_Journal_DialogTitle_Background_Quest_Lawkeeper_05B', Desc=''
Background_Quest_Lawkeeper_06A:	Title='Campaign/&CrownOfTheMagister_Journal_DialogTitle_Background_Quest_Lawkeeper_06A', Desc=''
Background_Quest_Lawkeeper_06B:	Title='Campaign/&CrownOfTheMagister_Journal_DialogTitle_Background_Quest_Lawkeeper_06B', Desc=''
Background_Quest_Lawkeeper_06C:	Title='Campaign/&CrownOfTheMagister_Journal_DialogTitle_Background_Quest_Lawkeeper_06C', Desc=''
Background_Quest_Lawkeeper_07:	Title='Campaign/&CrownOfTheMagister_Journal_DialogTitle_Background_Quest_Lawkeeper_07', Desc=''
Background_Quest_Lowlife_01_Merton:	Title='Campaign/&CrownOfTheMagister_Journal_DialogTitle_Background_Quest_Lowlife_01_Merton', Desc=''
Background_Quest_Lowlife_03_Nel:	Title='Campaign/&CrownOfTheMagister_Journal_DialogTitle_Background_Quest_Lowlife_03_Nel', Desc=''
Background_Quest_Lowlife_04_Gorim:	Title='Campaign/&CrownOfTheMagister_Journal_DialogTitle_Background_Quest_Lowlife_04_Gorim', Desc=''
Background_Quest_Lowlife_05_Karel:	Title='Campaign/&CrownOfTheMagister_Journal_DialogTitle_Background_Quest_Lowlife_05_Karel', Desc=''
Background_Quest_Lowlife_06_Nel:	Title='Campaign/&CrownOfTheMagister_Journal_DialogTitle_Background_Quest_Lowlife_06_Nel', Desc=''
Background_Quest_Lowlife_07_Nel:	Title='Campaign/&CrownOfTheMagister_Journal_DialogTitle_Background_Quest_Lowlife_07_Nel', Desc=''
Background_Quest_Lowlife_07_Nel_OBSOLETE:	Title='', Desc=''
Background_Quest_Lowlife_08_Nel_OBSOLETE:	Title='', Desc=''
Background_Quest_Philosopher_01:	Title='Campaign/&CrownOfTheMagister_Journal_DialogTitle_Background_Quest_Philosopher_01', Desc=''
Background_Quest_Philosopher_02:	Title='Campaign/&CrownOfTheMagister_Journal_DialogTitle_Background_Quest_Philosopher_02', Desc=''
Background_Quest_Philosopher_03:	Title='', Desc=''
Background_Quest_Philosopher_04:	Title='Campaign/&CrownOfTheMagister_Journal_DialogTitle_Background_Quest_Philosopher_04', Desc=''
Background_Quest_Philosopher_05:	Title='Campaign/&CrownOfTheMagister_Journal_DialogTitle_Background_Quest_Philosopher_05', Desc=''
Background_Quest_Philosopher_06:	Title='Campaign/&CrownOfTheMagister_Journal_DialogTitle_Background_Quest_Philosopher_06', Desc=''
Background_Quest_Philosopher_07:	Title='Campaign/&CrownOfTheMagister_Journal_DialogTitle_Background_Quest_Philosopher_07', Desc=''
Background_Quest_Philosopher_08:	Title='Campaign/&CrownOfTheMagister_Journal_DialogTitle_Background_Quest_Philosopher_08', Desc=''
Background_Quest_Philosopher_09:	Title='Campaign/&CrownOfTheMagister_Journal_DialogTitle_Background_Quest_Philosopher_09', Desc=''
Background_Quest_Sellsword_01_OBSOLETE:	Title='Campaign/&CrownOfTheMagister_Journal_DialogTitle_Background_Quest_Sellsword_01', Desc=''
Background_Quest_Sellsword_02:	Title='Campaign/&CrownOfTheMagister_Journal_DialogTitle_Background_Quest_Sellsword_02', Desc=''
Background_Quest_Sellsword_03:	Title='Campaign/&CrownOfTheMagister_Journal_DialogTitle_Background_Quest_Sellsword_03', Desc=''
Background_Quest_Sellsword_04:	Title='Campaign/&CrownOfTheMagister_Journal_DialogTitle_Background_Quest_Sellsword_04', Desc=''
Background_Quest_Sellsword_05:	Title='Campaign/&CrownOfTheMagister_Journal_DialogTitle_Background_Quest_Sellsword_05', Desc=''
Background_Quest_Sellsword_06A:	Title='Campaign/&CrownOfTheMagister_Journal_DialogTitle_Background_Quest_Sellsword_06A', Desc=''
Background_Quest_Sellsword_06B:	Title='Campaign/&CrownOfTheMagister_Journal_DialogTitle_Background_Quest_Sellsword_06B', Desc=''
Background_Quest_Sellsword_07:	Title='Campaign/&CrownOfTheMagister_Journal_DialogTitle_Background_Quest_Sellsword_07', Desc=''
Background_Quest_Sellsword_08:	Title='Campaign/&CrownOfTheMagister_Journal_DialogTitle_Background_Quest_Sellsword_08', Desc=''
Background_Quest_Sellsword_09:	Title='Campaign/&CrownOfTheMagister_Journal_DialogTitle_Background_Quest_Sellsword_09', Desc=''
Background_Quest_Spy_01:	Title='Campaign/&CrownOfTheMagister_Journal_DialogTitle_Background_Quest_Spy_01', Desc=''
Background_Quest_Spy_02:	Title='Campaign/&CrownOfTheMagister_Journal_DialogTitle_Background_Quest_Spy_02', Desc=''
Background_Quest_Spy_03:	Title='Campaign/&CrownOfTheMagister_Journal_DialogTitle_Background_Quest_Spy_03', Desc=''
Background_Quest_Spy_04:	Title='Campaign/&CrownOfTheMagister_Journal_DialogTitle_Background_Quest_Spy_04', Desc=''
Background_Quest_Spy_05:	Title='Campaign/&CrownOfTheMagister_Journal_DialogTitle_Background_Quest_Spy_05', Desc=''
Background_Quest_Spy_06:	Title='Campaign/&CrownOfTheMagister_Journal_DialogTitle_Background_Quest_Spy_06', Desc=''
Background_Quest_Spy_07:	Title='Campaign/&CrownOfTheMagister_Journal_DialogTitle_Background_Quest_Spy_07', Desc=''
Background_Quest_Spy_08:	Title='Campaign/&CrownOfTheMagister_Journal_DialogTitle_Background_Quest_Spy_08', Desc=''
Background_Quest_Wanderer_01:	Title='Campaign/&CrownOfTheMagister_Journal_DialogTitle_Background_Quest_Spy_02', Desc=''
Background_Quest_Wanderer_02:	Title='Campaign/&CrownOfTheMagister_Journal_DialogTitle_CaerCyflen_Act3_MeetingCarran_02', Desc=''
Background_Quest_Wanderer_02_Old:	Title='Campaign/&CrownOfTheMagister_Journal_DialogTitle_CaerCyflen_Act3_MeetingCarran_02', Desc=''
Background_Quest_Wanderer_03:	Title='Campaign/&CrownOfTheMagister_Journal_DialogTitle_Evocation_24_Necropolis_Emperor', Desc=''
Badlands_Ape_Presentation:	Title='', Desc=''
Badlands_Bear_Presentation:	Title='', Desc=''
BanditCombatDecisions:	Title='', Desc=''
BanditPackTacticsCombatDecisions:	Title='', Desc=''
Banner_A:	Title='Prop/&BannerTitle', Desc=''
Banner_B:	Title='Prop/&BannerTitle', Desc=''
Banner_C:	Title='Prop/&BannerTitle', Desc=''
Banner_D:	Title='Prop/&BannerTitle', Desc=''
Banner_E:	Title='Prop/&BannerTitle', Desc=''
Banner_F:	Title='Prop/&BannerTitle', Desc=''
Banner_G:	Title='Prop/&BannerTitle', Desc=''
BannerColumn_A:	Title='Prop/&BannerTitle', Desc=''
BannerColumn_B:	Title='Prop/&BannerTitle', Desc=''
BannerColumn_C:	Title='Prop/&BannerTitle', Desc=''
BannerColumn_D:	Title='Prop/&BannerTitle', Desc=''
BannerColumn_E:	Title='Prop/&BannerTitle', Desc=''
BannerColumn_F:	Title='Prop/&BannerTitle', Desc=''
BannerColumn_G:	Title='Prop/&BannerTitle', Desc=''
BannerColumn_H:	Title='Prop/&BannerTitle', Desc=''
BannerColumn_I:	Title='Prop/&BannerTitle', Desc=''
BannerColumn_J:	Title='Prop/&BannerTitle', Desc=''
BannerColumn_K:	Title='Prop/&BannerTitle', Desc=''
BanterEvent_Npc_ThiefDetected:	Title='', Desc=''
BanterEventAlliedKnockedDown:	Title='', Desc=''
BanterEventBreakStealth:	Title='', Desc=''
BanterEventCrawling:	Title='', Desc=''
BanterEventCriticalHitGiven:	Title='', Desc=''
BanterEventCriticalHitReceived:	Title='', Desc=''
BanterEventHealedByAlly:	Title='', Desc=''
BanterEventHighClimb:	Title='', Desc=''
BanterEventKillEnemy:	Title='', Desc=''
BanterEventLightUp:	Title='', Desc=''
BanterEventLongJump:	Title='', Desc=''
BanterEventMissedAttack:	Title='', Desc=''
BanterEventNormalHitGiven:	Title='', Desc=''
BanterEventNormalHitReceived:	Title='', Desc=''
BanterEventPushingHeavy:	Title='', Desc=''
BanterEventSecretDoorDetected:	Title='', Desc=''
BanterEventTrapDetected:	Title='', Desc=''
BanterEventTrapDisarmed:	Title='', Desc=''
BanterEventTrapTriggered:	Title='', Desc=''
BarCounter:	Title='Prop/&Tavern_CounterTitle', Desc=''
Barrack:	Title='Prop/&BarraksTitle', Desc=''
Barrel_A:	Title='Prop/&BarrelsTitle', Desc=''
Barrel_B:	Title='Prop/&BarrelsTitle', Desc=''
Barrel_C:	Title='Prop/&BarrelsTitle', Desc=''
Barrel_Street_A:	Title='Prop/&BarrelsTitle', Desc=''
Barrel_Street_B:	Title='Prop/&BarrelsTitle', Desc=''
Barrel_Street_C:	Title='Prop/&BarrelsTitle', Desc=''
Barrels:	Title='Prop/&BarrelsTitle', Desc=''
BarrelStack:	Title='Prop/&BarrelStackTitle', Desc=''
BarrelTavern_A:	Title='Prop/&BarrelsTitle', Desc=''
Basket_A:	Title='Prop/&BasketTitle', Desc=''
Basket_B:	Title='Prop/&BasketTitle', Desc=''
Beam:	Title='Prop/&ColumnTitle', Desc=''
BeamScreen_A:	Title='Prop/&Beam_ScreenTitle', Desc=''
BeamScreen_B:	Title='Prop/&Beam_ScreenTitle', Desc=''
Bed_A:	Title='Prop/&BedTitle', Desc=''
Bed_B:	Title='Prop/&BedTitle', Desc=''
Bed_C:	Title='Prop/&BedTitle', Desc=''
Bedroll_A:	Title='Prop/&BedrollTitle', Desc=''
Bedroll_B:	Title='Prop/&BedrollTitle', Desc=''
Bedroll_C:	Title='Prop/&BedrollTitle', Desc=''
Bedroll_D:	Title='Prop/&BedrollTitle', Desc=''
Bedroll_Tent_A:	Title='Prop/&TentTitle', Desc=''
Bedroll_Tent_B:	Title='Prop/&TentTitle', Desc=''
Bench_A:	Title='Prop/&BenchTitle', Desc=''
Bench_B:	Title='Prop/&BenchTitle', Desc=''
Bench_C:	Title='Prop/&BenchTitle', Desc=''
BestiaryStats:	Title='', Desc=''
BestiaryTable:	Title='', Desc=''
BigColumn_Bottom:	Title='Prop/&ColumnTitle', Desc=''
Birdcage:	Title='Prop/&BirdCageTitle', Desc=''
BitterrootTreasureCompatibilityScenario:	Title='', Desc=''
Black_Bear_Presentation:	Title='', Desc=''
Black_Dragon_Presentation:	Title='', Desc=''
Bluish:	Title='VisualMood/&BluishTitle', Desc=''
Bone_Keep_Scenario:	Title=' BONE KEEP SCENARIO STARTED FROM COTM MAIN', Desc=''
Bone_Keep_SUB_Scenario_Catacombs:	Title='BONE KEEP CATACOMBS STARTED FROM CEMETERY MAUSOLEUM', Desc=''
Bone_Keep_SUB_Scenario_Laboratory:	Title='BONE KEEP SCENARIO KEEP STARTED FROM THE SEWERS EXIT', Desc=''
Bone_Keep_SUB_Scenario_Lair:	Title='BONE KEEP SCENARIO KEEP STARTED FROM THE SEWERS EXIT', Desc=''
Bone_Keep_SUB_Scenario_Sewers:	Title='BONE KEEP DRAIN PIPE & SEWERS SCENARIO STARTED FROM COURTYARD ACCESS', Desc=''
Bone_Keep_SUB_Scenario_Solar:	Title='BONE KEEP SCENARIO KEEP STARTED FROM AKSHA TELEPORTER', Desc=''
BoneKeep:	Title='', Desc=''
BoneKeep_Quest:	Title='Quest/&BoneKeep', Desc=''
BoneKeep_Secondary_Quest_Adventurer:	Title='Quest/&Adventurer', Desc=''
BoneKeep_Secondary_Quest_Angbis_Bones:	Title='Quest/&Angbisbones', Desc=''
BoneKeepEndCompatibilityScenario_EA_0.4.0:	Title='Retrocompatibility fixes for crown gems 0.3.0 => 0.4.0', Desc=''
Bookshelf_A:	Title='Prop/&BookShelfTitle', Desc=''
Bookshelf_A_Covered:	Title='Prop/&BookShelfTitle', Desc=''
Bookshelf_B:	Title='Prop/&BookShelfTitle', Desc=''
Bookshelf_B_Covered:	Title='Prop/&BookShelfTitle', Desc=''
Bookshelf_C:	Title='Prop/&BookShelfTitle', Desc=''
Bookshelf_D:	Title='Prop/&BookShelfTitle', Desc=''
Bookshelf_E:	Title='Prop/&BookShelfTitle', Desc=''
BookStack_A:	Title='Prop/&BookStackTitle', Desc=''
BookStack_B:	Title='Prop/&BookStackTitle', Desc=''
BookStack_C:	Title='Prop/&BookStackTitle', Desc=''
Brasero_A:	Title='Prop/&BraseroTitle', Desc=''
Brasero_B:	Title='Prop/&BraseroTitle', Desc=''
Bridge:	Title='Prop/&BridgeTitle', Desc=''
Bridge_A:	Title='Prop/&BridgeTitle', Desc=''
Bridge_B:	Title='Prop/&BridgeTitle', Desc=''
Bridge_C:	Title='Prop/&BridgeTitle', Desc=''
BroodCombatDecisions:	Title='', Desc=''
Building_Cabin_12C:	Title='Room/&Building_Cabin_12CTitle', Desc=''
Building_Lodge_24C:	Title='Room/&Building_Lodge_24CTitle', Desc=''
BuletteCombatDecisions:	Title='', Desc=''
BuriedCity:	Title='', Desc=''
BurningDebris_A:	Title='Prop/&BurningDebrisTitle', Desc=''
BurningDebris_B:	Title='Prop/&BurningDebrisTitle', Desc=''
BurningDebris_C:	Title='Prop/&BurningDebrisTitle', Desc=''
BurningDebris_D:	Title='Prop/&BurningDebrisTitle', Desc=''
BurningDebris_E:	Title='Prop/&BurningDebrisTitle', Desc=''
Bushes_A:	Title='Prop/&BushesTitle', Desc=''
Bushes_B:	Title='Prop/&BushesTitle', Desc=''
Bushes_C:	Title='Prop/&BushesTitle', Desc=''
Cabinet_A:	Title='Prop/&CabinetTitle', Desc=''
Cabinet_B:	Title='Prop/&CabinetTitle', Desc=''
Cabinet_C:	Title='Prop/&CabinetTitle', Desc=''
Cabinet_Covered_A:	Title='Prop/&CabinetTitle', Desc=''
Cabinet_Covered_B:	Title='Prop/&CabinetTitle', Desc=''
Caer_Cyflen_At_War_Scenario:	Title='', Desc=''
Caer_Cyflen_Merton_Quest:	Title='Quest/&Caer_Cyflen_Merton_Quest_MainTitle', Desc=''
Caer_Cyflen_Merton_Quest2:	Title='Quest/&Caer_Cyflen_Merton2_Quest_MainTitle', Desc=''
Caer_Cyflen_Quest_AfterCaerLem:	Title='Quest/&Caer_Cyflen_Quest_AfterCaerLem_Title', Desc=''
Caer_Cyflen_Quest_AfterTowerOfMagic:	Title='Quest/&Caer_Cyflen_Quest_AfterTowerOfMagic_Title', Desc=''
Caer_Cyflen_Quest_AfterTutorial:	Title='Quest/&Caer_Cyflen_Quest_AfterTutorial_Title', Desc=''
Caer_Cyflen_Quest_Council03:	Title='Quest/&Caer_Cyflen_Quest_Council03_Title', Desc=''
Caer_Cyflen_Quest_Council04:	Title='Quest/&Caer_Cyflen_Quest_Council04_Title', Desc=''
Caer_Cyflen_Scenario_Council_00:	Title='CAER CYFLEN NPC ROUTINE + COUNCIL SCENARIO', Desc=''
Caer_Cyflen_Scenario_Council_00_SAVE:	Title='CAER CYFLEN NPC ROUTINE + COUNCIL SCENARIO', Desc=''
Caer_Cyflen_Scenario_Council_01:	Title='Started After Leaving Caer Lem', Desc=''
Caer_Cyflen_Scenario_Council_02:	Title='Started After Leaving Caer Lem', Desc=''
Caer_Cyflen_Scenario_Council_03:	Title='', Desc=''
Caer_Cyflen_Scenario_Council_04:	Title='ACT 3', Desc=''
Caer_Cyflen_Secondary_Quest_AfterTutorial:	Title='Campaign/&CrownOfTheMagister_Journal_DialogTitle_Annie02', Desc=''
Caer_Cyflen_Secondary_Quest_Visit_Hugo:	Title='Quest/&Caer_Cyflen_Visit_Hugo_Title', Desc=''
Caer_Lem_Goblin_Cave_Quest:	Title='Quest/&Caer_Lem_Goblin_Cave_Quest_Title', Desc=''
Caer_Lem_Quest:	Title='Quest/&Caer_Lem_Title', Desc=''
Caer_Lem_Return_Scenario:	Title='RETURN TO CAER LEM SCENARIO', Desc=''
Caer_Lem_Scavengers_Talk_to_Henrik:	Title='Quest/&Scavengers_Henrik_Quest_Title', Desc=''
Caer_Lem_Scenario:	Title='CAER LEM SCENARIO STARTED BY CAMPAIGN', Desc=''
Caer_Lem_SUB_Scenario_Goblins_Cave:	Title='Caer Lem Scenario Started after Council_00 in Caer Cyflen', Desc=''
CaerCyflen_Act3_00_CannotFindGems:	Title='Campaign/&CrownOfTheMagister_Journal_DialogTitle_CaerCyflen_Act3_00_CannotFindGems', Desc=''
CaerCyflen_Act3_01_Return:	Title='Campaign/&CrownOfTheMagister_Journal_DialogTitle_CaerCyflen_Act3_01_Return', Desc=''
CaerCyflen_Act3_01_Return_Without_Arwin:	Title='Campaign/&CrownOfTheMagister_Journal_DialogTitle_CaerCyflen_Act3_01_Return', Desc=''
CaerCyflen_Act3_02_Bartender:	Title='Campaign/&CrownOfTheMagister_Journal_DialogTitle_CaerCyflen_Act3_02_Bartender', Desc=''
CaerCyflen_Act3_Beryl:	Title='Campaign/&CrownOfTheMagister_Journal_DialogTitleCaerCyflen_Act3_Beryl', Desc=''
CaerCyflen_Act3_CovenOfArivad_01:	Title='Campaign/&CrownOfTheMagister_Journal_DialogTitle_CaerCyflen_Act3_CovenOfArivad_01', Desc=''
CaerCyflen_Act3_CovenOfArivad_02:	Title='Campaign/&CrownOfTheMagister_Journal_DialogTitle_CaerCyflen_Act3_CovenOfArivad_02', Desc=''
CaerCyflen_Act3_CovenOfArivad_03:	Title='Campaign/&CrownOfTheMagister_Journal_DialogTitle_CaerCyflen_Act3_CovenOfArivad_03', Desc=''
CaerCyflen_Act3_MeetingCarran_01:	Title='Campaign/&CrownOfTheMagister_Journal_DialogTitle_CaerCyflen_Act3_MeetingCarran_01', Desc=''
CaerCyflen_Act3_MeetingCarran_02:	Title='Campaign/&CrownOfTheMagister_Journal_DialogTitle_CaerCyflen_Act3_MeetingCarran_02', Desc=''
CaerCyflen_Act3_Robar:	Title='Campaign/&CrownOfTheMagister_Journal_DialogTitle_CaerCyflen_Act3_Robar', Desc=''
CaerCyflen_Act3_SummersHouse:	Title='Campaign/&CrownOfTheMagister_Journal_CaerCyflen_Act3_SummersHouse', Desc=''
CaerCyflen_Act3_SummersHouse_WithoutDaliat:	Title='Campaign/&CrownOfTheMagister_Journal_CaerCyflen_Act3_SummersHouse', Desc=''
CaerCyflen_Act3_TempleOfEinar_01:	Title='Campaign/&CrownOfTheMagister_Journal_CaerCyflen_Act3_TempleOfEinar_01', Desc=''
CaerCyflen_Act3_TempleOfEinar_02:	Title='Campaign/&CrownOfTheMagister_Journal_CaerCyflen_Act3_TempleOfEinar_02', Desc=''
CaerCyflen_Act3_TempleOfEinar_03:	Title='Campaign/&CrownOfTheMagister_Journal_CaerCyflen_Act3_TempleOfEinar_03', Desc=''
CaerCyflen_Act3_TempleOfEinar_04:	Title='Campaign/&CrownOfTheMagister_Journal_CaerCyflen_Act3_TempleOfEinar_04', Desc=''
CaerCyflen_Act3_TempleOfEinar_05:	Title='Campaign/&CrownOfTheMagister_Journal_CaerCyflen_Act3_TempleOfEinar_05', Desc=''
CaerCyflen_Act3_TempleOfEinar_06:	Title='Campaign/&CrownOfTheMagister_Journal_CaerCyflen_Act3_TempleOfEinar_06', Desc=''
CaerCyflen_Act3_TempleOfEinar_07:	Title='Campaign/&CrownOfTheMagister_Journal_CaerCyflen_Act3_TempleOfEinar_07', Desc=''
CaerLem:	Title='', Desc=''
Cage_A:	Title='Prop/&CageTitle', Desc=''
Cage_B:	Title='Prop/&CageTitle', Desc=''
Calm:	Title='VisualMood/&CalmTitle', Desc=''
Campaign_COTM_Scenario:	Title='CAMPAIGN SCENARIO COTM', Desc=''
Candelabra_A:	Title='Prop/&CandelabraTitle', Desc=''
Candelabra_Covered_A:	Title='Prop/&CandelabraTitle', Desc=''
CaptainIronshell_AfterAttack:	Title='Campaign/&CrownOfTheMagister_Journal_DialogTitle_PriestOfArun', Desc=''
Caravan:	Title='', Desc=''
Caravan_A:	Title='Prop/&CaravanTitle', Desc=''
Caravan_B:	Title='Prop/&CaravanTitle', Desc=''
Caravan_Quest:	Title='Quest/&Caravan_Title', Desc=''
CaravanReturnCompatibilityScenario_EA_0.5.41:	Title='', Desc=''
Carpet_A:	Title='Prop/&CarpetTitle', Desc=''
Carpet_B:	Title='Prop/&CarpetTitle', Desc=''
Carpet_C:	Title='Prop/&CarpetTitle', Desc=''
Carpet_D:	Title='Prop/&CarpetTitle', Desc=''
Carpet_E:	Title='Prop/&CarpetTitle', Desc=''
Carpet_F:	Title='Prop/&CarpetTitle', Desc=''
Cart_A:	Title='Prop/&CartTitle', Desc=''
Cart_B:	Title='Prop/&CartTitle', Desc=''
Cart_C:	Title='Prop/&CartTitle', Desc=''
CasterCombatDecisions:	Title='', Desc=''
Castle_Fence_A:	Title='Prop/&CastleWallTitle', Desc=''
Castle_Fence_B:	Title='Prop/&CastleWallTitle', Desc=''
Castle_Fence_Filler:	Title='Prop/&CastleWallFillerTitle', Desc=''
Castle_InnerDoor_A:	Title='Prop/&CastleWallDoorwayTitle', Desc=''
Castle_InnerDoor_B:	Title='Prop/&CastleWallDoorwayTitle', Desc=''
Castle_InnerDoor_C:	Title='Prop/&CastleWallDoorwayTitle', Desc=''
Castle_InnerObstacle_A:	Title='Prop/&CastleWallObstacleTitle', Desc=''
Castle_InnerObstacle_B:	Title='Prop/&CastleWallObstacleTitle', Desc=''
Castle_InnerObstacle_C:	Title='Prop/&CastleWallObstacleTitle', Desc=''
Castle_InnerObstacle_D:	Title='Prop/&CastleWallObstacleTitle', Desc=''
Castle_InnerWall_A:	Title='Prop/&CastleInnerWallTitle', Desc=''
Castle_InnerWall_B:	Title='Prop/&CastleInnerWallTitle', Desc=''
Castle_InnerWall_C:	Title='Prop/&CastleInnerWallTitle', Desc=''
Castle_InnerWall_D:	Title='Prop/&CastleInnerWallTitle', Desc=''
Castle_InnerWall_E:	Title='Prop/&CastleInnerWallTitle', Desc=''
Castle_InnerWall_F:	Title='Prop/&CastleInnerWallTitle', Desc=''
Castle_InnerWall_Filler:	Title='Prop/&CastleWallFillerTitle', Desc=''
Castle_InnerWall_G:	Title='Prop/&CastleInnerWallTitle', Desc=''
Castle_InnerWall_H:	Title='Prop/&CastleInnerWallTitle', Desc=''
Castle_InnerWall_I:	Title='Prop/&CastleInnerWallTitle', Desc=''
Castle_InnerWall_J:	Title='Prop/&CastleInnerWallTitle', Desc=''
Castle_InnerWall_K:	Title='Prop/&CastleInnerWallTitle', Desc=''
Castle_InnerWall_L:	Title='Prop/&CastleInnerWallTitle', Desc=''
Castle_InnerWall_M:	Title='Prop/&CastleInnerWallTitle', Desc=''
Castle_Ladder:	Title='Prop/&LadderTitle', Desc=''
Castle_LadderSmall:	Title='Prop/&LadderTitle', Desc=''
Castle_Scaffolding:	Title='Prop/&ScaffoldingTitle', Desc=''
Castle_Tower_A:	Title='Prop/&CastleTowerTitle', Desc=''
Castle_Tower_B:	Title='Prop/&CastleTowerTitle', Desc=''
Castle_Tower_C:	Title='Prop/&CastleTowerTitle', Desc=''
Castle_Tower_D:	Title='Prop/&CastleTowerTitle', Desc=''
Castle_Tower_E:	Title='Prop/&CastleTowerTitle', Desc=''
Castle_Tower_F:	Title='Prop/&CastleTowerTitle', Desc=''
Castle_Wall_A:	Title='Prop/&CastleWallTitle', Desc=''
Castle_Wall_B:	Title='Prop/&CastleWallTitle', Desc=''
Castle_Wall_C:	Title='Prop/&CastleWallTitle', Desc=''
Castle_Wall_D:	Title='Prop/&CastleWallTitle', Desc=''
CastMagic_ActionSurge_Self:	Title='', Desc=''
CastMagic_Blindness:	Title='', Desc=''
CastMagic_Buff_AoE:	Title='', Desc=''
CastMagic_Buff_WithRandom:	Title='', Desc=''
CastMagic_Debuff_AoE:	Title='', Desc=''
CastMagic_Debuff_AoE_Legendary:	Title='', Desc=''
CastMagic_Debuff_AoE_Legendary_NoRandom:	Title='', Desc=''
CastMagic_Debuff_AoE_MummyLord_BlasphemousWords:	Title='', Desc=''
CastMagic_Debuff_AoE_MummyLord_BlindingDust:	Title='', Desc=''
CastMagic_Debuff_AoE_MummyLord_ChannelNegativeEnergy:	Title='', Desc=''
CastMagic_Debuff_SingleTarget:	Title='', Desc=''
CastMagic_Debuff_SingleTarget_NoRandom:	Title='', Desc=''
CastMagic_Defiler_Darkness:	Title='', Desc=''
CastMagic_Defiler_Teleport:	Title='', Desc=''
CastMagic_Defiler_Teleport_Fallback:	Title='', Desc=''
CastMagic_DPS_AoE:	Title='', Desc=''
CastMagic_DPS_AoE_DragonBreath:	Title='', Desc=''
CastMagic_DPS_AoE_Legendary:	Title='', Desc=''
CastMagic_DPS_LifeLeech_SingleTarget:	Title='', Desc=''
CastMagic_DPS_LifeLeech_SingleTargetOnAlly_Defiler:	Title='', Desc=''
CastMagic_DPS_LifeLeech_SingleTargetOnAlly_SpiderQueen:	Title='', Desc=''
CastMagic_DPS_SingleTarget:	Title='', Desc=''
CastMagic_DPS_SingleTarget_Blight:	Title='', Desc=''
CastMagic_Fly_Self:	Title='', Desc=''
CastMagic_FrightfulPresence_Dragon:	Title='', Desc=''
CastMagic_Haste_Others:	Title='', Desc=''
CastMagic_Heal_SingleTarget:	Title='', Desc=''
CastMagic_Heal_SingleTargetWithRandom:	Title='', Desc=''
CastMagic_HoldPerson:	Title='', Desc=''
CastMagic_Reckless_Self:	Title='', Desc=''
CastMagic_SelfBuff:	Title='', Desc=''
CastMagic_SelfBuff_WithRandom:	Title='', Desc=''
CastMagic_SelfHeal:	Title='', Desc=''
CastMagic_ShamblingMound_Engulf:	Title='', Desc=''
CastMagic_SorakSaboteurDebuff:	Title='', Desc=''
CastMagic_Teleport:	Title='', Desc=''
CastMagic_Teleport_Aggressive:	Title='', Desc=''
CastMagic_Teleport_Reposition:	Title='', Desc=''
CaveEntrance_A:	Title='Prop/&CaveEntranceTitle', Desc=''
CaveEntrance_B:	Title='Prop/&CaveEntranceTitle', Desc=''
Caves_InnerDoor_A:	Title='Prop/&CaveWallDoorwaysTitle', Desc=''
Cell_A:	Title='Prop/&CellTitle', Desc=''
Cell_B:	Title='Prop/&CellTitle', Desc=''
Cemetery_Pilar:	Title='Prop/&Walls_LowTitle', Desc=''
Cemetery_Wall_A:	Title='Prop/&Walls_LowTitle', Desc=''
Cemetery_Wall_B:	Title='Prop/&Walls_LowTitle', Desc=''
Cemetery_Wall_C:	Title='Prop/&Walls_LowTitle', Desc=''
Cemetery_Wall_D:	Title='Prop/&Walls_LowTitle', Desc=''
Chain_A:	Title='Prop/&WallChainTitle', Desc=''
Chain_B:	Title='Prop/&WallChainTitle', Desc=''
Chair_A:	Title='Prop/&ChairTitle', Desc=''
Chair_B:	Title='Prop/&ChairTitle', Desc=''
Chair_B_Covered:	Title='Prop/&ChairTitle', Desc=''
ChairTavern_A:	Title='Prop/&ChairTitle', Desc=''
Charge:	Title='', Desc=''
ChargeAttack_Default:	Title='', Desc=''
City:	Title='', Desc=''
City_DLC1:	Title='', Desc=''
Clearing_Large_24C:	Title='Room/&Clearing_Large_24CTitle', Desc=''
Clearing_Small_12C:	Title='Room/&Clearing_Small_12CTitle', Desc=''
ClearOutdoor:	Title='VisualMood/&ClearOutdoorTitle', Desc=''
ClericCombatDecisions:	Title='', Desc=''
Cocoon_A:	Title='Prop/&CocoonTitle', Desc=''
Cocoon_B:	Title='Prop/&CocoonTitle', Desc=''
Cold:	Title='VisualMood/&ColdTitle', Desc=''
Column_B:	Title='Prop/&ColumnBTitle', Desc=''
Column_C:	Title='Prop/&ColumnBTitle', Desc=''
Column_D:	Title='Prop/&ColumnTitle', Desc=''
Column_Pennant:	Title='Prop/&PennantTitle', Desc=''
Compatibility_ChangeMerton:	Title='Make sure Merton has changed', Desc=''
Compatibility_Council04_Quest_Lost:	Title='Catchup with Council 4 quest if Scenario got ahead', Desc=''
Compatibility_Legendary_Exit:	Title='CheckIfLegendaryQuestDone, then unlock exit', Desc=''
Compatibility_LockEvocationExit_1.0:	Title='Before this patch, exit to world map was not locked', Desc=''
Complex:	Title='', Desc=''
ConclusionLore:	Title='', Desc=''
Confused_Attack:	Title='', Desc=''
Confused_Attack:	Title='', Desc=''
Confused_Move:	Title='', Desc=''
Confused_Move:	Title='', Desc=''
Conjuration_01_Entrance:	Title='Campaign/&CrownOfTheMagister_Journal_DialogTitle_Conjuration_01_Entrance', Desc=''
Conjuration_01b_PoisonousBulb:	Title='', Desc=''
Conjuration_01c_PoisonousBulb:	Title='', Desc=''
Conjuration_02_Jungle:	Title='Campaign/&CrownOfTheMagister_Journal_DialogTitle_Conjuration_02_Jungle', Desc=''
Conjuration_02b_LavaBurst:	Title='', Desc=''
Conjuration_03_Lava:	Title='Campaign/&CrownOfTheMagister_Journal_DialogTitle_Conjuration_03_Lava', Desc=''
Conjuration_04_GardenSheld:	Title='Campaign/&CrownOfTheMagister_Journal_DialogTitle_Conjuration_04_GardenSheld', Desc=''
Conjuration_05_SorakFight:	Title='Campaign/&CrownOfTheMagister_Journal_DialogTitle_Conjuration_05_SorakFight', Desc=''
Conjuration_06_Interrogation:	Title='Campaign/&CrownOfTheMagister_Journal_DialogTitle_Conjuration_06_Interrogation', Desc=''
Conjuration_07_IntroducingGate:	Title='', Desc=''
Conjuration_07b_UnlockGate:	Title='', Desc=''
Conjuration_08_CollapsingTunnel:	Title='', Desc=''
Conjuration_09_TreasureBeast:	Title='Campaign/&CrownOfTheMagister_Journal_DialogTitle_Conjuration_09_TreasureBeast', Desc=''
Conjuration_10_Beast:	Title='Campaign/&CrownOfTheMagister_Journal_DialogTitle_Conjuration_10_Beast', Desc=''
Conjuration_11_BeastEnding:	Title='Campaign/&CrownOfTheMagister_Journal_DialogTitle_Conjuration_11_BeastEnding', Desc=''
Conjuration_12_ShitfingMaze:	Title='Campaign/&CrownOfTheMagister_Journal_DialogTitle_Conjuration_12_ShitfingMaze', Desc=''
Conjuration_13_TeleportingCircle:	Title='Campaign/&CrownOfTheMagister_Journal_DialogTitle_Conjuration_13_TeleportingCircle', Desc=''
Conjuration_13b_TeleportingCircle:	Title='Campaign/&CrownOfTheMagister_Journal_DialogTitle_Conjuration_13b_TeleportingCircle', Desc=''
Conjuration_13c_IntroducingColorChange:	Title='', Desc=''
Conjuration_14_Coward:	Title='Campaign/&CrownOfTheMagister_Journal_DialogTitle_Conjuration_14_Coward', Desc=''
Conjuration_14b_Coward:	Title='Campaign/&CrownOfTheMagister_Journal_DialogTitle_Conjuration_14b_Coward', Desc=''
Conjuration_15_MansionArrival:	Title='Campaign/&CrownOfTheMagister_Journal_DialogTitle_Conjuration_15_MansionArrival', Desc=''
Conjuration_16_CastleEntrance:	Title='Campaign/&CrownOfTheMagister_Journal_DialogTitle_Conjuration_16_CastleEntrance', Desc=''
Conjuration_17_InvisibleServants:	Title='Campaign/&CrownOfTheMagister_Journal_DialogTitle_Conjuration_17_InvisibleServants', Desc=''
Conjuration_18_Master:	Title='Campaign/&CrownOfTheMagister_Journal_DialogTitle_Conjuration_18_Master', Desc=''
Conjuration_19_MasterDragon:	Title='', Desc=''
Conjuration_20_IntroducingGemInShed:	Title='', Desc=''
Conjuration_Quest:	Title='Quest/&Conjuration_Title', Desc=''
Conjuration_Quest_Arena:	Title='Quest/&Conjuration_Arena_Title', Desc=''
Conjuration_Quest_SuperEgo_Mansion_HelpServant:	Title='Quest/&Conjuration_SuperEgo_Mansion_HelpServant_Title', Desc=''
Conjuration_Quest_SuperEgo_Mansion_HelpSlave:	Title='Quest/&Conjuration_SuperEgo_Mansion_HelpSlave_Title', Desc=''
Conjuration_Quest_SuperEgo_Mansion_Loot:	Title='Quest/&Conjuration_SuperEgo_Mansion_Loot_Title', Desc=''
Conjuration_Scenario:	Title='CONJURATION SCENARIO STARTED FROM COTM MAIN', Desc=''
ConjurationForestCompatibilityScenario:	Title='Catchup with Council 4 quest if Scenario got ahead', Desc=''
ConsoleTable:	Title='', Desc=''
CookingStuff_A:	Title='Prop/&CookingStuffTitle', Desc=''
Coparann_Cleric:	Title='Campaign/&CrownOfTheMagister_Journal_Coparann_Cleric', Desc=''
Coparann_ClericBaronSaved:	Title='Campaign/&CrownOfTheMagister_Journal_Coparann_Cleric', Desc=''
Coparann_Quest:	Title='Quest/&Abjuration_Visit_Scavs_Title', Desc=''
Coparann_Scavengers:	Title='Campaign/&CrownOfTheMagister_Journal_Coparann_Scavengers', Desc=''
Coparann_ScavengersBaronSaved:	Title='Campaign/&CrownOfTheMagister_Journal_Coparann_Scavengers', Desc=''
Coparann_Telema_EndFight:	Title='', Desc=''
CoparannHardLockedBaronRoomDoorCompatibilityScenario:	Title='', Desc=''
Corner_12C:	Title='Room/&Corner_12CTitle', Desc=''
Corner_Crypt_12C:	Title='Room/&Crossroad_12CTitle', Desc=''
Corpse_A:	Title='Prop/&CorpseTitle', Desc=''
Corpse_B:	Title='Prop/&CorpseTitle', Desc=''
Corpse_C:	Title='Prop/&CorpseTitle', Desc=''
Corpse_D:	Title='Prop/&CorpseTitle', Desc=''
Corpse_Pile_A:	Title='Prop/&CorpseTitle', Desc=''
Couch_A:	Title='Prop/&CouchTitle', Desc=''
Couch_B:	Title='Prop/&CouchTitle', Desc=''
Couch_C:	Title='Prop/&CouchTitle', Desc=''
Couch_Corner_A:	Title='Prop/&CouchTitle', Desc=''
Couch_Corner_B:	Title='Prop/&CouchTitle', Desc=''
Council_03_a:	Title='Campaign/&CrownOfTheMagister_Journal_DialogTitle_Council03_a', Desc=''
Council_03_b:	Title='Campaign/&CrownOfTheMagister_Journal_DialogTitle_Council03_b', Desc=''
Council_04_a:	Title='Campaign/&CrownOfTheMagister_Journal_DialogTitle_Council_04_a', Desc=''
Council_04_b:	Title='Campaign/&CrownOfTheMagister_Journal_DialogTitle_Council_04_b', Desc=''
Council_04_c_1_Attacked_In_Residency:	Title='Campaign/&CrownOfTheMagister_Journal_DialogTitle_Council_04_c_1_Attacked_In_Residency', Desc=''
Council_04_d_Talking_To_Heddlon:	Title='Campaign/&CrownOfTheMagister_Journal_DialogTitle_Council_04_d_Talking_To_Heddlon', Desc=''
Council_04_e_Ironshell_After_Attack:	Title='Campaign/&CrownOfTheMagister_Journal_DialogTitle_Council_04_e_Ironshell_After_Attack', Desc=''
Council_05_a:	Title='Campaign/&CrownOfTheMagister_Journal_DialogTitle_Council_05_a', Desc=''
Council_05_b:	Title='Campaign/&CrownOfTheMagister_Journal_DialogTitle_Council_05_b', Desc=''
Council_05_c:	Title='Campaign/&CrownOfTheMagister_Journal_DialogTitle_Council_05_c', Desc=''
CR10_DLC1_CrimsonBadlandsPhaseSpiders_x1_x2_x1_x2:	Title='', Desc=''
CR10_DLC1_GiantApe_Apes_x1_x2_x1:	Title='', Desc=''
CR10_DLC1_MutantGiantApe_x1:	Title='', Desc=''
CR10_DLC1_MutBlkBear_GhostWolf_x1_x1:	Title='', Desc=''
CR10_DLC1_Necro_MutZomb_MutDireWlf_SkelEnfr_x1_x4_x1_x1:	Title='', Desc=''
CR10_DLC1_SpiderSpec_Mummy_Beetle_SkelSorc_x2_x1_x1_x1:	Title='', Desc=''
CR10_DLC1_Trolls_x1_x1:	Title='', Desc=''
CR10_DLC1_WightLord_MutDireWlf_Skeletons_Enforcer_x1_x1_x1_x4:	Title='', Desc=''
CR11_DLC1_Dryad_Bear_MutantBear_x1_x3_x1_x2:	Title='', Desc=''
CR11_DLC1_GhostWolf_Wight_x2_x1:	Title='', Desc=''
CR11_DLC1_ShamblingMound_Mummy_x1_x2:	Title='', Desc=''
CR11_DLC1_ShamblingMound_Zombie_SkelMarks_x1_x4_x1:	Title='', Desc=''
CR11_DLC1_SpectralMino_Mummy_x1_x1:	Title='', Desc=''
CR12_DLC1_DeepCrimsonSpider_Dryad_x1_x1_x1_x1:	Title='', Desc=''
CR12_DLC1_GhostWolf_SpecAveng_x2_x1:	Title='', Desc=''
CR12_DLC1_GiantApe_Ape_x1_x3_x2:	Title='', Desc=''
CR12_DLC1_MutBlkBears_x1_x1:	Title='', Desc=''
CR12_DLC1_MutGiantApe_MutApe_MutZomb_x1_x2_x4_x2:	Title='', Desc=''
CR12_DLC1_Necro&Aco_MutZomb_SkelKnight_x1_x1_x4_x1:	Title='', Desc=''
CR12_DLC1_Necro_SkelMarks_Skeletons_x1_x1_x3_x1:	Title='', Desc=''
CR12_DLC1_TigerDrake_MutBlkBear_x2_x1_x1:	Title='', Desc=''
CR12_DLC1_YoungRemorhaz_x1_x1:	Title='', Desc=''
CR13_DLC1_MutBlkBear_MutDireWolf_x1_x1_x1:	Title='', Desc=''
CR13_DLC1_ShamblingMounds_GiantCrows_x1_x1_x3:	Title='', Desc=''
CR13_DLC1_Troll_GhostWolf_x1_x2:	Title='', Desc=''
CR13_DLC1_WightLord_Wight_Skeleton_x1_x2_x4:	Title='', Desc=''
CR14_DLC1_BadlandsHunter_DireWolf_ShockArca_FireJest_x1_x1_x1_x2:	Title='', Desc=''
CR14_DLC1_Mutants_BlkBear_BwnBear_Dryad_x1_x1_x1_x1:	Title='', Desc=''
CR14_DLC1_Mutants_Bulette_BlkBear_Apes_x1_x1_x3:	Title='', Desc=''
CR14_DLC1_StoneGiant_Troll_BrownBear_x1_x1_x2:	Title='', Desc=''
CR15_DLC1_BadlandsCrimsonPhaseSpiders_x4_x1_x1_x1:	Title='', Desc=''
CR15_DLC1_CrimsonSpiders_x1_x1_x1:	Title='', Desc=''
CR15_DLC1_EarthElem_ShamblingMound_AirElem_x1_x1_x1:	Title='', Desc=''
CR15_DLC1_GiantApes_Ape_x1_x1_x1:	Title='', Desc=''
CR15_DLC1_Mummy_Beetle_PhaseSpectralSpiders_x2_x2_x1_x2:	Title='', Desc=''
CR15_DLC1_Mutants_GiantApe_Ape_x1_x3_x2:	Title='', Desc=''
CR15_DLC1_Trolls_MutBulette_x1_x1_x1:	Title='', Desc=''
CR2_DLC1_Hunters_and_Scavengers_x4_x1_x1:	Title='', Desc=''
CR3_DLC1_TEST:	Title='', Desc=''
CR4_DLC1_Minotaur_BrownBear_x1_x1:	Title='', Desc=''
CR4_DLC1_Minotaur_Dryad_x1_x1:	Title='', Desc=''
CR4_DLC1_MutatedApeRange_x1_x2_x1:	Title='Encounter/&CR3_AgressiveGorillas_Title ', Desc=''
CR5_DLC1_Berserker_Werewolf_x1_x1:	Title='', Desc=''
CR5_DLC1_Minotaur_Spy_Bandit_x1_x1_x2_x2:	Title='', Desc=''
CR5_DLC1_Pilgrim_BadlandsSpider_X1_x1_x1:	Title='', Desc=''
CR5_DLC1_Pilgrim_OrcShaman_x1_x1:	Title='', Desc=''
CR7_DLC1_Darkweaver_Spies_x1_x1_x1:	Title='', Desc=''
CR7_DLC1_GiantApe_x1:	Title='', Desc=''
CR7_DLC1_GiantBeetle_Mummy_x2_x1:	Title='', Desc=''
CR7_DLC1_HillGiant_BrownBear_x1_x2:	Title='', Desc=''
CR7_DLC1_Mummy_Wight_ZombieMutant_x1_x1_x4:	Title='', Desc=''
CR7_DLC1_Necromancer_Zombies_x1_x4:	Title='', Desc=''
CR7_DLC1_SkelSorcerer_Zombies_SkelKnight_x1_x2_x2_x1:	Title='', Desc=''
CR7_DLC1_Troll_DireWolf_x1_x1_x1:	Title='', Desc=''
CR7_DLC1_Werewolf_Pack_x1_x1_x1:	Title='', Desc=''
CR8_DLC1_Archmage_Highwayman_Bandits_x1_x2_x2_x2:	Title='', Desc=''
CR8_DLC1_CrimsonPhaseSpiders_x1_x1:	Title='', Desc=''
CR8_DLC1_CrimsonSpider_GiantBeetle_Spider_x1_x1_x2:	Title='', Desc=''
CR8_DLC1_Dryads_Veterans_x1_x1_x1_x1:	Title='', Desc=''
CR8_DLC1_EliteMinotaur_Minotaur_x1_x1:	Title='', Desc=''
CR8_DLC1_GiantApe_Bandits_x1_x3_x3:	Title='', Desc=''
CR8_DLC1_GiantApe_Dryad_x1_x1:	Title='', Desc=''
CR8_DLC1_MutantBears_x1_x2:	Title='', Desc=''
CR8_DLC1_Mutated_Sleuth_x1_x1_x2:	Title='', Desc=''
CR8_DLC1_Pilgrim_x1_x1:	Title='', Desc=''
CR8_DLC1_Skeletons_Wolf_GhostWolf_x1_x1_x4_x4:	Title='', Desc=''
CR8_DLC1_SpectralMinotaur_x1:	Title='', Desc=''
CR8_DLC1_TigerDrake_BrimstoneViper_PhaseSpider_Spider_x2_x4_x1_x1:	Title='', Desc=''
CR8_DLC1_Warlord_Bandit_Highwayman_x1_x4_x1:	Title='', Desc=''
CR8_DLC1_WightLord_Skeletons_Spider_x1_x2_x2_x1:	Title='', Desc=''
CR9_DLC1_Beetles_CrimsonSpider_x1_x1_x1:	Title='', Desc=''
CR9_DLC1_Mummies_Beetle_ApeMut_x2_x1_x4:	Title='', Desc=''
CR9_DLC1_Mummy_Beetle_Skeletons_x1_x2_x2_x2:	Title='', Desc=''
CR9_DLC1_MutantBulette_MutDireWolf_SkelSorcerer_x1_x1_x1:	Title='', Desc=''
CR9_DLC1_SkelKnight_SkelMarks_MutZombie_x1_x1_x4:	Title='', Desc=''
Cradle_Of_Fire_Quest:	Title='Quest/&CradleOfFire_Title', Desc=''
Cradle_Of_Fire_Quest_Bladefang:	Title='Quest/&CradleOfFire_Bladefang_Title', Desc=''
Cradle_Of_Fire_Quest_Bloodspear:	Title='Quest/&CradleOfFire_Bloodspear_Title', Desc=''
Cradle_Of_Fire_Quest_OLD:	Title='Quest/&CradleOfFire_Title', Desc=''
Cradle_Of_Fire_Quest_SandRaven:	Title='Quest/&CradleOfFire_Bladefang_Title', Desc=''
Cradle_Of_Fire_Scenario_Evocation:	Title='CradleOfFire', Desc=''
Crate_A:	Title='Prop/&CrateTitle', Desc=''
Crate_B:	Title='Prop/&CrateTitle', Desc=''
Crate_C:	Title='Prop/&CrateTitle', Desc=''
CrateStack_A:	Title='Prop/&CrateStackTitle', Desc=''
CrateStack_B:	Title='Prop/&CrateStackTitle', Desc=''
CreditsTable:	Title='', Desc=''
Creeper_A:	Title='Prop/&CreeperTitle', Desc=''
Creeper_B:	Title='Prop/&CreeperTitle', Desc=''
Creeper_C:	Title='Prop/&CreeperTitle', Desc=''
CriticalCharacter:	Title='', Desc=''
Crossroad_12C:	Title='Room/&Crossroad_12CTitle', Desc=''
Crossroad_12C_Organic:	Title='Room/&Crossroad_12CTitle', Desc=''
CrownCompatibilityScenario_EA_0.4.0:	Title='Retrocompatibility fixes for crown gems 0.3.0 => 0.4.0', Desc=''
Crypt:	Title='VisualMood/&CryptTitle', Desc=''
CubeOfLightCombatDecisions:	Title='', Desc=''
Curve_12C:	Title='Room/&Curve_12CTitle', Desc=''
Curve_24C:	Title='Room/&Curve_24CTitle', Desc=''
Curve_U_24C:	Title='Room/&Curve_U_24CTitle', Desc=''
Cushions_A:	Title='Prop/&CushionsTitle', Desc=''
Cushions_B:	Title='Prop/&CushionsTitle', Desc=''
DailyLog:	Title='', Desc=''
Dam_A:	Title='Prop/&WallSimpleTitle', Desc=''
DatabaseIndex:	Title='', Desc=''
Debug_LookAtTest:	Title='', Desc=''
Decorative_House_B:	Title='Prop/&HousePatchTitle', Desc=''
DeepSpiderCombatDecisions:	Title='', Desc=''
DefaultFlyingBeastWithBackupRangeCombatDecisions:	Title='', Desc=''
DefaultMeleeBeastCombatDecisions:	Title='', Desc=''
DefaultMeleeBeastWithBackupRangeCombatDecisions:	Title='', Desc=''
DefaultMeleeWithBackupRangeDecisions:	Title='', Desc=''
DefaultRangeWithBackupMeleeDecisions:	Title='', Desc=''
DefaultSupportCasterWithBackupAttacksDecisions:	Title='', Desc=''
DefilerCombatDecisions:	Title='', Desc=''
Desk_A:	Title='Prop/&DeskTitle', Desc=''
DestroyedStuff_A:	Title='Prop/&BrokenFurnituresTitle', Desc=''
DestroyedStuff_B:	Title='Prop/&BrokenFurnituresTitle', Desc=''
DestroyedStuff_C:	Title='Prop/&BrokenFurnituresTitle', Desc=''
DestroyedStuff_D:	Title='Prop/&BrokenFurnituresTitle', Desc=''
DestroyedStuff_E:	Title='Prop/&BrokenFurnituresTitle', Desc=''
DestroyedStuff_F:	Title='Prop/&BrokenFurnituresTitle', Desc=''
DestroyedStuff_G:	Title='Prop/&BrokenFurnituresTitle', Desc=''
DestroyedStuff_H:	Title='Prop/&BrokenFurnituresTitle', Desc=''
DestroyedStuff_I:	Title='Prop/&BrokenFurnituresTitle', Desc=''
DestroyedStuff_J:	Title='Prop/&BrokenFurnituresTitle', Desc=''
DestroyedStuff_K:	Title='Prop/&BrokenFurnituresTitle', Desc=''
DestroyedStuff_L:	Title='Prop/&BrokenFurnituresTitle', Desc=''
Devilish:	Title='VisualMood/&DevilishTitle', Desc=''
DieRollModifierCaerLemMonsterInitiativeFirst:	Title='', Desc=''
DieRollModifierHyeronimusAttackRollCritical:	Title='', Desc=''
DieRollModifierPlayerInitiativeFirstHyeronimus:	Title='', Desc=''
DieRollModifierTutorialLiamAttackRollDisadvantage:	Title='', Desc=''
DieRollModifierTutorialPlayerAbilityCheckAdvantage:	Title='', Desc=''
DieRollModifierTutorialPlayerAttackRollAdvantage:	Title='', Desc=''
DieRollModifierTutorialPlayerAttackRollCritical:	Title='', Desc=''
DieRollModifierTutorialPlayerInitiativeFirst:	Title='', Desc=''
DieRollModifierTutorialWolfAbilityCheckPenalty:	Title='', Desc=''
DieRollModifierTutorialWolfAlphaAttack:	Title='', Desc=''
DieRollModifierTutorialWolfAlphaDamage:	Title='', Desc=''
DieRollModifierTutorialWolfDamagePenalty:	Title='', Desc=''
DieRollModifierTutorialWolfInitiativeLast:	Title='', Desc=''
DieRollModifierTutorialWolfSavingThrowAndAttackRollPenalty:	Title='', Desc=''
DifficultyPresetAuthentic:	Title='', Desc=''
DifficultyPresetCataclysm:	Title='', Desc=''
DifficultyPresetExplorer:	Title='', Desc=''
DifficultyPresetScavenger:	Title='', Desc=''
DifficultyPresetStory:	Title='', Desc=''
DisengageAfterAttack:	Title='', Desc=''
DisengageIfInMeleeRange:	Title='', Desc=''
DLC1_CityEncounterTable:	Title='', Desc=''
DLC1_EmptyNar:	Title='', Desc=''
DLC1_EncounterTable_NoMutants:	Title='', Desc=''
DLC1_EncounterTableFull:	Title='', Desc=''
DLC1_JungleEncounterTable:	Title='', Desc=''
DLC1_Narrative_Complex_CS_01_Enter_Complex_intro:	Title='Narration/&Complex_CS_01', Desc=''
DLC1_Narrative_Complex_CS_02_End:	Title='Narration/&Complex_CS_02', Desc=''
DLC1_Narrative_Complex_CS_02_First_Meeting_Scientist_AND_COMPLEX_01:	Title='Narration/&Complex_CS_02', Desc=''
DLC1_Narrative_Complex_CS_03_COMPLEX_02:	Title='Narration/&Complex_CS_03', Desc=''
DLC1_Narrative_Complex_CS_03_COMPLEX_02_End:	Title='Narration/&Complex_CS_03', Desc=''
DLC1_Narrative_Complex_CS_04_COMPLEX_03:	Title='Narration/&Complex_CS_04', Desc=''
DLC1_Narrative_Complex_CS_05_COMPLEX_04:	Title='Narration/&Complex_CS_05', Desc=''
DLC1_Narrative_Complex_CS_06_Discover_Lockdown:	Title='Narration/&Complex_CS_06', Desc=''
DLC1_Narrative_Complex_CS_08_Talk_Scholar:	Title='Narration/&Complex_CS_08', Desc=''
DLC1_Narrative_Complex_CS_09_Discover_Captivity_Center:	Title='Narration/&Complex_CS_06', Desc=''
DLC1_Narrative_Complex_CS_10_Major_Gate:	Title='Narration/&Complex_CS_06', Desc=''
DLC1_Narrative_Valley_CS_01_Enter_Valley_intro:	Title='Narration/&Valley_CS_01', Desc=''
DLC1_Narrative_Valley_CS_07_First_Meeting_Samko_AND_MASK_01:	Title='Narration/&Valley_CS_09', Desc=''
DLC1_Narrative_Valley_CS_08_Samko_MASK_02:	Title='Narration/&Valley_CS_10', Desc=''
DLC1_Narrative_Valley_CS_09_Cafrain_MASK_04:	Title='Narration/&Valley_CS_11', Desc=''
DLC1_Narrative_Valley_CS_09_Cafrain_MASK_04_Read:	Title='Narration/&Valley_CS_12', Desc=''
DLC1_Narrative_Valley_CS_09_Cafrain_MASK_05:	Title='Narration/&Valley_CS_13', Desc=''
DLC1_Narrative_Valley_CS_09_Cafrain_MASK_06:	Title='Narration/&Valley_CS_14', Desc=''
DLC1_Narrative_Valley_CS_09_Klarn_MASK_08:	Title='Narration/&Valley_CS_15', Desc=''
DLC1_Narrative_Valley_CS_09_Klarn_MASK_09:	Title='Narration/&Valley_CS_16', Desc=''
DLC1_Narrative_Valley_CS_09_Samko_MASK_05_End:	Title='Narration/&Valley_CS_17', Desc=''
DLC1_Narrative_Valley_CS_09_Samko_MASK_06_End:	Title='Narration/&Valley_CS_18', Desc=''
DLC1_Narrative_Valley_CS_09_Samko_MASK_07:	Title='Narration/&Valley_CS_19', Desc=''
DLC1_Narrative_Valley_CS_09_Samko_MASK_07_End:	Title='Narration/&Valley_CS_20', Desc=''
DLC1_Narrative_Valley_CS_11_Klarn_MASK_11_End:	Title='Narration/&Valley_CS_22', Desc=''
DLC1_Narrative_Valley_CS_11_Klarn_MASK_11_Start:	Title='Narration/&Valley_CS_21', Desc=''
DLC1_Narrative_Valley_CS_12_First_Meeting_Giant_Trader_AND_GIANT_01:	Title='Narration/&Valley_CS_23', Desc=''
DLC1_Narrative_Valley_CS_13_GIANT_02:	Title='Narration/&Valley_CS_24', Desc=''
DLC1_Narrative_Valley_CS_14_GIANT_03:	Title='Narration/&Valley_CS_25', Desc=''
DLC1_Narrative_Valley_CS_15_GIANT_03_End:	Title='Narration/&Valley_CS_26', Desc=''
DLC1_Narrative_Valley_CS_16_GIANT_04:	Title='Narration/&Valley_CS_27', Desc=''
DLC1_Narrative_Valley_CS_17_GIANT_04_Mid:	Title='Narration/&Valley_CS_28', Desc=''
DLC1_Narrative_Valley_CS_18_GIANT_05:	Title='Narration/&Valley_CS_29', Desc=''
DLC1_Narrative_Valley_CS_19_GIANT_06:	Title='Narration/&Valley_CS_30', Desc=''
DLC1_Narrative_Valley_Cut_Cam_Treasure_Room:	Title='', Desc=''
DLC1_Narrative_Valley_Cut_Cam_Treasure_Room_A:	Title='', Desc=''
DLC1_Narrative_Valley_Cut_Cam_Treasure_Room_B:	Title='', Desc=''
DLC1_Narrative_Valley_Cut_Cam_Treasure_Room_C:	Title='', Desc=''
DLC1_Narrative_Valley_Cut_Cam_Treasure_Room_D:	Title='', Desc=''
DLC1_NarrativeTree_CS01_Speak_With_Galar:	Title='Narration/&DLC1_Marches_CS01', Desc=''
DLC1_NarrativeTree_CS02_Speak_With_Helia:	Title='Narration/&DLC1_Marches_CS02', Desc=''
DLC1_NarrativeTree_CS03_Speak_With_Nobleman:	Title='Narration/&DLC1_Marches_CS03', Desc=''
DLC1_NarrativeTree_CS04_BarrierIsOpen:	Title='Narration/&DLC1_Marches_CS04', Desc=''
DLC1_NarrativeTree_CS05_Speak_With_Rogue:	Title='Narration/&DLC1_Marches_CS05', Desc=''
DLC1_NarrativeTree_CS06_Speak_With_Mercenary:	Title='Narration/&DLC1_Marches_CS06', Desc=''
DLC1_NarrativeTree_CS07_Speak_With_Helia_SecondVisit:	Title='Narration/&DLC1_Marches_CS07', Desc=''
DLC1_NarrativeTree_CS08_Speak_With_Rogue_Complete:	Title='Narration/&DLC1_Marches_CS08', Desc=''
DLC1_NarrativeTree_CS09_QuestMercenaryPelt:	Title='Narration/&DLC1_Marches_CS09', Desc=''
DLC1_NarrativeTree_CS11_LootVIPBag:	Title='Narration/&DLC1_Marches_CS10', Desc=''
DLC1_NarrativeTree_CS12_RedeemCompanions:	Title='', Desc=''
DLC1_NarrativeTree_CS30_TrappedByRedeemers:	Title='Narration/&DLC1_Marches_CS11', Desc=''
DLC1_NarrativeTree_CS35_Exited_Nest:	Title='Narration/&DLC1_Marches_CS12', Desc=''
DLC1_NarrativeTree_Ending_01_Marches:	Title='', Desc=''
DLC1_NarrativeTree_Ending_02_Throne:	Title='', Desc=''
DLC1_NarrativeTree_Ending_03A_ComplexDoor:	Title='', Desc=''
DLC1_NarrativeTree_Ending_03B_ComplexUnderground:	Title='', Desc=''
DLC1_NarrativeTree_Ending_04A_CyflenCouncil:	Title='', Desc=''
DLC1_NarrativeTree_Ending_04B_MisayeTemple:	Title='', Desc=''
DLC1_NarrativeTree_Ending_04C_MarchesCamp:	Title='', Desc=''
DLC1_NarrativeTree_Ending_04D_MarinVingHideout:	Title='', Desc=''
DLC1_NarrativeTree_Forge_CS_Quest01_Meet_Telerien:	Title='Narration/&Valley_CS_02', Desc=''
DLC1_NarrativeTree_Forge_CS_Quest02_Start:	Title='Narration/&Valley_CS_03', Desc=''
DLC1_NarrativeTree_Forge_CS_Quest03_End:	Title='Narration/&Valley_CS_04', Desc=''
DLC1_NarrativeTree_Forge_CS_Quest03_Start:	Title='Narration/&Valley_CS_05', Desc=''
DLC1_NarrativeTree_Forge_CS_Quest04_End_Meet_Hasdrubal:	Title='Narration/&Swamp_CS_05', Desc=''
DLC1_NarrativeTree_Forge_CS_Quest05_End:	Title='Narration/&Swamp_CS_06', Desc=''
DLC1_NarrativeTree_Forge_CS_Quest05_Start:	Title='Narration/&Swamp_CS_08', Desc=''
DLC1_NarrativeTree_Forge_CS_Quest06_Ambush:	Title='Narration/&Swamp_CS_10', Desc=''
DLC1_NarrativeTree_Forge_CS_Quest06_End:	Title='Narration/&Swamp_CS_12', Desc=''
DLC1_NarrativeTree_Forge_CS_Quest06_Outpost:	Title='Narration/&Swamp_CS_11', Desc=''
DLC1_NarrativeTree_Forge_CS_Quest06_Start:	Title='Narration/&Swamp_CS_09', Desc=''
DLC1_NarrativeTree_Forge_CS_Quest07_Meeting:	Title='Narration/&Swamp_CS_13', Desc=''
DLC1_NarrativeTree_Forge_CS_Quest07_Meeting_AfterBattle_BetrayedForge:	Title='Narration/&Valley_CS_31', Desc=''
DLC1_NarrativeTree_Forge_CS_Quest07_Meeting_AfterBattle_BetrayedRebellion:	Title='Narration/&Valley_CS_31', Desc=''
DLC1_NarrativeTree_Forge_CS_Quest07_Start:	Title='Narration/&Swamp_CS_14', Desc=''
DLC1_NarrativeTree_Forge_CS_Quest08_End:	Title='', Desc=''
DLC1_NarrativeTree_Forge_CS_Quest08_Start:	Title='Narration/&Valley_CS_07', Desc=''
DLC1_NarrativeTree_Forge_CS_Quest09_End:	Title='Narration/&Valley_CS_08', Desc=''
DLC1_NarrativeTree_Forge_CS_Quest09_Start:	Title='Narration/&Valley_CS_08', Desc=''
DLC1_NarrativeTree_FreePrisonner_01:	Title='', Desc=''
DLC1_NarrativeTree_FreePrisonner_02and03:	Title='', Desc=''
DLC1_NarrativeTree_Karelia_Inn:	Title='Narration/&Valley_CS_32', Desc=''
DLC1_NarrativeTree_Karelia_Orenetis_06_Mid:	Title='Narration/&Valley_CS_33', Desc=''
DLC1_NarrativeTree_MysteriousPalace_BattleRoom_PressurePlate:	Title='', Desc=''
DLC1_NarrativeTree_MysteriousPalace_Corridor_PressurePlate:	Title='', Desc=''
DLC1_NarrativeTree_MysteriousPalace_Corridor_ShowRooms:	Title='', Desc=''
DLC1_NarrativeTree_MysteriousPalace_EndQuest:	Title='', Desc=''
DLC1_NarrativeTree_MysteriousPalace_StartQuest:	Title='', Desc=''
DLC1_NarrativeTree_Orenetis_01:	Title='Narration/&CS_Title_Orenetis_01', Desc=''
DLC1_NarrativeTree_Orenetis_02:	Title='Narration/&CS_Title_Orenetis_02', Desc=''
DLC1_NarrativeTree_Orenetis_03:	Title='Quest/&DLC1_Secondary_Quest_City_Orenetis_01_TITLE', Desc=''
DLC1_NarrativeTree_Orenetis_03b:	Title='Quest/&DLC1_Secondary_Quest_City_Orenetis_01_TITLE', Desc=''
DLC1_NarrativeTree_Orenetis_04:	Title='Narration/&Orenetis_CS_04', Desc=''
DLC1_NarrativeTree_Orenetis_04_FoundLysantir:	Title='Narration/&Orenetis_CS_04_FoundLysantir', Desc=''
DLC1_NarrativeTree_Orenetis_05:	Title='Narration/&Orenetis_CS_05', Desc=''
DLC1_NarrativeTree_Orenetis_05_Anfarel:	Title='Narration/&Orenetis_CS_06', Desc=''
DLC1_NarrativeTree_Orenetis_05_AnfarelEnd:	Title='Narration/&Orenetis_CS_07', Desc=''
DLC1_NarrativeTree_Orenetis_05_EndQuest:	Title='Narration/&Orenetis_CS_08', Desc=''
DLC1_NarrativeTree_Orenetis_05_StartQuest:	Title='Narration/&Orenetis_CS_09', Desc=''
DLC1_NarrativeTree_Orenetis_05_TestLysantir:	Title='Narration/&Orenetis_CS_10', Desc=''
DLC1_NarrativeTree_Orenetis_06_End:	Title='Narration/&Orenetis_CS_06_End', Desc=''
DLC1_NarrativeTree_Orenetis_06_Start:	Title='Narration/&Valley_CS_34', Desc=''
DLC1_NarrativeTree_Orenetis_07_EndQuest:	Title='', Desc=''
DLC1_NarrativeTree_Orenetis_07_StartQuest:	Title='', Desc=''
DLC1_NarrativeTree_Orenetis_08_Start:	Title='Narration/&Orenetis_CS_11', Desc=''
DLC1_NarrativeTree_Orenetis_09_End:	Title='Narration/&Orenetis_CS_13', Desc=''
DLC1_NarrativeTree_Orenetis_09_Start:	Title='Narration/&Orenetis_CS_12', Desc=''
DLC1_NarrativeTree_Orenetis_Sitenero_Fusion:	Title='Narration/&Valley_CS_35', Desc=''
DLC1_NarrativeTree_Orenetis_Sitenero_Meet:	Title='Narration/&Valley_CS_35', Desc=''
DLC1_NarrativeTree_PlanB_MarinVing:	Title='Narration/&Orenetis_CS_12', Desc=''
DLC1_NarrativeTree_Rebellion_01:	Title='Narration/&CS_Title_ThePeople02', Desc=''
DLC1_NarrativeTree_Rebellion_02_StartQuest:	Title='Narration/&Valley_CS_36', Desc=''
DLC1_NarrativeTree_Rebellion_03_Incriminate:	Title='Narration/&Valley_CS_37', Desc=''
DLC1_NarrativeTree_Rebellion_03_KilledCharmer:	Title='Narration/&Valley_CS_38', Desc=''
DLC1_NarrativeTree_Rebellion_03_SeeingCharmer:	Title='Narration/&Valley_CS_39', Desc=''
DLC1_NarrativeTree_Rebellion_03_StartQuest:	Title='Narration/&Valley_CS_40', Desc=''
DLC1_NarrativeTree_Rebellion_04_EndQuest:	Title='Quest/&DLC1_Secondary_Quest_Rebellion_05_Title', Desc=''
DLC1_NarrativeTree_Rebellion_04_StartQuest:	Title='Quest/&DLC1_Secondary_Quest_Rebellion_05_Title', Desc=''
DLC1_NarrativeTree_Rebellion_05_StartQuest:	Title='Quest/&DLC1_Secondary_Quest_Rebellion_05_Title', Desc=''
DLC1_NarrativeTree_Rebellion_06_EndQuest:	Title='', Desc=''
DLC1_NarrativeTree_Rebellion_06_StartQuest:	Title='', Desc=''
DLC1_NarrativeTree_Rebellion_07_EndQuest:	Title='', Desc=''
DLC1_NarrativeTree_Rebellion_07_StartQuest:	Title='', Desc=''
DLC1_NarrativeTree_Rebellion_08_EndQuest:	Title='', Desc=''
DLC1_NarrativeTree_Rebellion_09_EndQuest_EllariaAlive:	Title='', Desc=''
DLC1_NarrativeTree_Rebellion_09_EndQuest_EllariaDead:	Title='', Desc=''
DLC1_NarrativeTree_Rebellion_10_AfterMeeting:	Title='', Desc=''
DLC1_NarrativeTree_Rebellion_10_End:	Title='', Desc=''
DLC1_NarrativeTree_Rebellion_10_EnterTomb:	Title='', Desc=''
DLC1_NarrativeTree_Rebellion_10_MeetHendeolas:	Title='', Desc=''
DLC1_NarrativeTree_Rebellion_10_StartQuest_Renno:	Title='', Desc=''
DLC1_NarrativeTree_Sitenero:	Title='', Desc=''
DLC1_NarrativeTree_Swamp_02_EnterPalace:	Title='', Desc=''
DLC1_NarrativeTree_Swamp_02_ExplorePalace:	Title='', Desc=''
DLC1_NarrativeTree_Swamp_02_FindHut:	Title='', Desc=''
DLC1_NarrativeTree_Swamp_02_FindRuins:	Title='', Desc=''
DLC1_NarrativeTree_Swamp_02_GetPassword:	Title='', Desc=''
DLC1_NarrativeTree_Swamp_02_MeetGhost:	Title='', Desc=''
DLC1_NarrativeTree_Swamp_02_MeetWitch:	Title='', Desc=''
DLC1_NarrativeTree_Swamp_02_MeetWitch_Hostile:	Title='', Desc=''
DLC1_NarrativeTree_Swamp_02_Report:	Title='', Desc=''
DLC1_NarrativeTree_Swamp_02_SecretPassage_Inside:	Title='', Desc=''
DLC1_NarrativeTree_Swamp_02_SecretPassage_Opened:	Title='', Desc=''
DLC1_NarrativeTree_Swamp_03_FindRuins:	Title='Narration/&Valley_CS_41', Desc=''
DLC1_NarrativeTree_Swamp_03_MeetTuznut:	Title='Narration/&Valley_CS_42', Desc=''
DLC1_NarrativeTree_Swamp_03_OpenDoor:	Title='Narration/&Valley_CS_43', Desc=''
DLC1_NarrativeTree_Swamp_03_Save_Rugan:	Title='Narration/&Valley_CS_41', Desc=''
DLC1_NarrativeTree_Swamp_03_StartRitual:	Title='Narration/&Valley_CS_44', Desc=''
DLC1_NarrativeTree_Swamp_GIANT_AskHasdrubalToFreeRugan:	Title='', Desc=''
DLC1_NarrativeTree_Swamp_GIANT_RuganEscapedHasdrubalCalled:	Title='', Desc=''
DLC1_NarrativeTree_Swamp_GIANT_SpeakToRugan:	Title='', Desc=''
DLC1_NarrativeTree_ThePeople_01:	Title='Narration/&CS_Title_ThePeople01', Desc=''
DLC1_NarrativeTree_ThePeople_02:	Title='Narration/&CS_Title_ThePeople02', Desc=''
DLC1_NarrativeTree_ThePeople_02_End:	Title='Narration/&CS_Title_ThePeople02', Desc=''
DLC1_NarrativeTree_ThePeople_02B:	Title='Narration/&CS_Title_ThePeople02', Desc=''
DLC1_NarrativeTree_ThePeople_03:	Title='Narration/&CS_Title_ThePeople03', Desc=''
DLC1_NarrativeTree_ThePeople_03_Bully:	Title='Narration/&CS_Title_ThePeople03', Desc=''
DLC1_NarrativeTree_ThePeople_03_End:	Title='Narration/&CS_Title_ThePeople03', Desc=''
DLC1_NarrativeTree_ThePeople_04:	Title='Narration/&CS_Title_ThePeople04', Desc=''
DLC1_NarrativeTree_ThePeople_04_Denounce:	Title='Narration/&CS_Title_ThePeople03_Denounce', Desc=''
DLC1_NarrativeTree_ThePeople_04_End:	Title='Narration/&CS_Title_ThePeople04', Desc=''
DLC1_NarrativeTree_ThePeople_04_Intro_Reya:	Title='Narration/&CS_Title_ThePeople05', Desc=''
DLC1_NarrativeTree_ThePeople_04_Sharpeyes:	Title='Narration/&CS_Title_ThePeople03', Desc=''
DLC1_NarrativeTree_ThePeople_04_SharpeyesReplaced:	Title='Narration/&CS_Title_ThePeople03', Desc=''
DLC1_NarrativeTree_ThePeople_05_Save:	Title='Narration/&CS_Title_ThePeople06', Desc=''
DLC1_NarrativeTree_ThePeople_05_StartQuest:	Title='Narration/&CS_Title_ThePeople06', Desc=''
DLC1_NarrativeTree_ThePeople_06_ReyaFound:	Title='Narration/&CS_Title_ThePeople07', Desc=''
DLC1_NarrativeTree_ThePeople_06_ReyaSaved:	Title='Narration/&CS_Title_ThePeople07', Desc=''
DLC1_NarrativeTree_ThePeople_06_StartQuest:	Title='Narration/&CS_Title_ThePeople07', Desc=''
DLC1_NarrativeTree_ThePeople_07_Outpost:	Title='Narration/&CS_Title_ThePeople09', Desc=''
DLC1_NarrativeTree_ThePeople_07_StartQuest:	Title='Narration/&CS_Title_ThePeople08', Desc=''
DLC1_NarrativeTree_ThePeople_08_End:	Title='Narration/&CS_Title_ThePeople10', Desc=''
DLC1_NarrativeTree_ThePeople_08_Start:	Title='Narration/&Orenetis_CS_12', Desc=''
DLC1_Outpost_Control_Scenario:	Title='', Desc=''
DLC1_Quest_Backup_PLAN_B:	Title='Quest/&DLC1_Quest_Backup_PLAN_B', Desc=''
DLC1_Quest_Backup_PLAN_C:	Title='Quest/&DLC1_Quest_Backup_PLAN_C', Desc=''
DLC1_Quest_Complex:	Title='Quest/&DLC1_Quest_Complex', Desc=''
DLC1_Quest_End_Of_ DLC_Own_Scepter:	Title='Quest/&DLC1_Quest_End_Of_ DLC_Own_Scepter', Desc=''
DLC1_Quest_MAIN:	Title='Quest/&DLC1_Quest_MAIN_TITLE', Desc=''
DLC1_Quest_Marches:	Title='Quest/&DLC1_Quest_Marches', Desc=''
DLC1_Quest_Marches_Meet_Everyone:	Title='DLC1_Quest_Marches_NPC2_Spy', Desc=''
DLC1_Quest_Marches_NPC1_Rogue:	Title='Quest/&DLC1_Quest_Marches_NPC1_Scribe', Desc=''
DLC1_Quest_Marches_NPC2_Mercenary:	Title='Quest/&DLC1_Quest_Marches_NPC2_Mercenary_MainTitle', Desc=''
DLC1_Quest_Marches_NPC2_Spy:	Title='Quest/&DLC1_Quest_Marches_NPC2_Spy', Desc=''
DLC1_Quest_MysteriousPalace:	Title='Quest/&DLC1_Quest_MysteriousPalace_Title', Desc=''
DLC1_Quest_Secondary_FindNestKey:	Title='Quest/&DLC1_Quest_Marches_FindNestKey', Desc=''
DLC1_Quest_Valley:	Title='Quest/&DLC1_Quest_Valley', Desc=''
DLC1_Scenario_Buried_City:	Title='Started by Cs_ThePeople01 in City', Desc=''
DLC1_Scenario_Campaign:	Title='', Desc=''
DLC1_Scenario_Campaign_Backup_PLAN:	Title='', Desc=''
DLC1_Scenario_Campaign_NPC:	Title='', Desc=''
DLC1_Scenario_City:	Title='Started by Cs_ThePeople01 in City', Desc=''
DLC1_Scenario_Complex:	Title='', Desc=''
DLC1_Scenario_Ending:	Title='', Desc=''
DLC1_Scenario_Marches:	Title='', Desc=''
DLC1_Scenario_Marches_NPC2_Mercenary:	Title='', Desc=''
DLC1_Scenario_Marches_NPC2_Rogue:	Title='', Desc=''
DLC1_Scenario_Marches_NPC2_Spy:	Title='', Desc=''
DLC1_Scenario_Marches_Scepter_Tracking:	Title='', Desc=''
DLC1_Scenario_MysteriousPalace:	Title='', Desc=''
DLC1_Scenario_Swamp:	Title='', Desc=''
DLC1_Scenario_Valley:	Title='', Desc=''
DLC1_Scenario_Valley_Underground:	Title='', Desc=''
DLC1_Scenario_Valley_Underground_Caves:	Title='', Desc=''
DLC1_Secondary_Quest_City_Mask_04:	Title='Quest/&DLC1_Secondary_Quest_Valley_Mask_04', Desc=''
DLC1_Secondary_Quest_City_Mask_05:	Title='Quest/&DLC1_Secondary_Quest_Valley_Mask_05', Desc=''
DLC1_Secondary_Quest_City_Mask_06:	Title='Quest/&DLC1_Secondary_Quest_Valley_Mask_06', Desc=''
DLC1_Secondary_Quest_City_Mask_07:	Title='Quest/&DLC1_Secondary_Quest_Valley_Mask_07', Desc=''
DLC1_Secondary_Quest_City_Mask_08:	Title='Quest/&DLC1_Secondary_Quest_Valley_Mask_08', Desc=''
DLC1_Secondary_Quest_City_Mask_08B:	Title='Quest/&DLC1_Secondary_Quest_Valley_Mask_08B', Desc=''
DLC1_Secondary_Quest_City_Mask_09:	Title='Quest/&DLC1_Secondary_Quest_Valley_Mask_09', Desc=''
DLC1_Secondary_Quest_City_Mask_09B:	Title='Quest/&DLC1_Secondary_Quest_Valley_Mask_09', Desc=''
DLC1_Secondary_Quest_City_Orenetis_01:	Title='Quest/&DLC1_Secondary_Quest_City_Orenetis_01_TITLE', Desc=''
DLC1_Secondary_Quest_City_Orenetis_01_Scenario:	Title='', Desc=''
DLC1_Secondary_Quest_City_Rebellion_01:	Title='Quest/&DLC1_Secondary_Quest_City_Rebellion_01_TITLE', Desc=''
DLC1_Secondary_Quest_City_Rebellion_01_Scenario:	Title='', Desc=''
DLC1_Secondary_Quest_City_ThePeople02:	Title='Quest/&DLC1_Secondary_Quest_City_ThePeople02_TITLE', Desc=''
DLC1_Secondary_Quest_City_ThePeople02_Scenario:	Title='', Desc=''
DLC1_Secondary_Quest_City_ThePeople03:	Title='Quest/&DLC1_Secondary_Quest_City_ThePeople03_TITLE', Desc=''
DLC1_Secondary_Quest_City_ThePeople04:	Title='Quest/&DLC1_Secondary_Quest_City_ThePeople04_TITLE', Desc=''
DLC1_Secondary_Quest_Complex_01:	Title='Quest/&DLC1_Secondary_Quest_Complex_01', Desc=''
DLC1_Secondary_Quest_Complex_02:	Title='Quest/&DLC1_Secondary_Quest_Complex_02', Desc=''
DLC1_Secondary_Quest_Complex_03:	Title='Quest/&DLC1_Secondary_Quest_Complex_03', Desc=''
DLC1_Secondary_Quest_Complex_04:	Title='Quest/&DLC1_Secondary_Quest_Complex_04', Desc=''
DLC1_Secondary_Quest_Complex_Locked_Elevator:	Title='Quest/&DLC1_Secondary_Quest_Complex_Locked_Elevator', Desc=''
DLC1_Secondary_Quest_Complex_Open_Gate_03_Underground:	Title='Quest/&DLC1_Secondary_Quest_Complex_Open_Gate_03', Desc=''
DLC1_Secondary_Quest_Complex_Open_Gate_DarkLab:	Title='Quest/&DLC1_Secondary_Quest_Complex_Open_Gate_DarkLab', Desc=''
DLC1_Secondary_Quest_Complex_Open_Gate_Underground:	Title='Quest/&DLC1_Secondary_Quest_Complex_Open_Gate_Underground', Desc=''
DLC1_Secondary_Quest_Complex_Open_Security_Gate:	Title='Quest/&DLC1_Secondary_Quest_Complex_Open_Gate', Desc=''
DLC1_Secondary_Quest_Forge_06:	Title='Quest/&DLC1_Secondary_Quest_Forge_06_Title', Desc=''
DLC1_Secondary_Quest_Forge_07:	Title='Quest/&DLC1_Secondary_Quest_Forge_07_Title', Desc=''
DLC1_Secondary_Quest_Forge_08:	Title='Quest/&DLC1_Secondary_Quest_Forge_08_Title', Desc=''
DLC1_Secondary_Quest_Forge_09:	Title='Quest/&DLC1_Secondary_Quest_Forge_09_Title', Desc=''
DLC1_Secondary_Quest_Orenetis_02:	Title='Quest/&DLC1_Secondary_Quest_Orenetis_02_Title', Desc=''
DLC1_Secondary_Quest_Orenetis_02_Scenario:	Title='', Desc=''
DLC1_Secondary_Quest_Orenetis_03:	Title='Quest/&DLC1_Secondary_Quest_Orenetis_03', Desc=''
DLC1_Secondary_Quest_Orenetis_03_Scenario:	Title='', Desc=''
DLC1_Secondary_Quest_Orenetis_05:	Title='Quest/&DLC1_Secondary_Quest_Orenetis_05_Title', Desc=''
DLC1_Secondary_Quest_Orenetis_05_Scenario:	Title='', Desc=''
DLC1_Secondary_Quest_Orenetis_06:	Title='Quest/&DLC1_Secondary_Quest_Orenetis_06_Title', Desc=''
DLC1_Secondary_Quest_Orenetis_06_Scenario:	Title='', Desc=''
DLC1_Secondary_Quest_Orenetis_07:	Title='Quest/&DLC1_Secondary_Quest_Orenetis_07_Title', Desc=''
DLC1_Secondary_Quest_Orenetis_07_Scenario:	Title='', Desc=''
DLC1_Secondary_Quest_Orenetis_08:	Title='Quest/&DLC1_Secondary_Quest_Orenetis_08_Title', Desc=''
DLC1_Secondary_Quest_Orenetis_08_Scenario:	Title='', Desc=''
DLC1_Secondary_Quest_Orenetis_09:	Title='Quest/&DLC1_Secondary_Quest_Orenetis_09_Title', Desc=''
DLC1_Secondary_Quest_Orenetis_09_Scenario:	Title='', Desc=''
DLC1_Secondary_Quest_Rebellion_02:	Title='Quest/&DLC1_Secondary_Quest_Rebellion_02_Title', Desc=' '
DLC1_Secondary_Quest_Rebellion_02_Scenario:	Title='', Desc=''
DLC1_Secondary_Quest_Rebellion_03:	Title='Quest/&DLC1_Secondary_Quest_City_Rebellion_03_Title', Desc=''
DLC1_Secondary_Quest_Rebellion_03_Scenario:	Title='', Desc=''
DLC1_Secondary_Quest_Rebellion_04:	Title='Quest/&DLC1_Secondary_Quest_Rebellion_04_Title', Desc=' '
DLC1_Secondary_Quest_Rebellion_04_Scenario:	Title='', Desc=' '
DLC1_Secondary_Quest_Rebellion_05:	Title='Quest/&DLC1_Secondary_Quest_Rebellion_05_Title', Desc=' '
DLC1_Secondary_Quest_Rebellion_05_Scenario:	Title='', Desc=' '
DLC1_Secondary_Quest_Rebellion_06:	Title='Quest/&DLC1_Secondary_Quest_Rebellion_06_Title', Desc=' '
DLC1_Secondary_Quest_Rebellion_06_Scenario:	Title='', Desc=' '
DLC1_Secondary_Quest_Rebellion_07:	Title='Quest/&DLC1_Secondary_Quest_Rebellion_07_Title', Desc=' '
DLC1_Secondary_Quest_Rebellion_07_Scenario:	Title='', Desc=' '
DLC1_Secondary_Quest_Rebellion_08:	Title='Quest/&DLC1_Secondary_Quest_Rebellion_08_Title', Desc=''
DLC1_Secondary_Quest_Rebellion_08_Scenario:	Title='', Desc=''
DLC1_Secondary_Quest_Rebellion_09_Quest:	Title='Quest/&DLC1_Secondary_Quest_Rebellion_09_QuestTitle', Desc=''
DLC1_Secondary_Quest_Rebellion_09_Scenario:	Title='', Desc=''
DLC1_Secondary_Quest_Rebellion_10_Quest:	Title='Quest/&DLC1_Secondary_Quest_Rebellion_10_QuestTitle', Desc=''
DLC1_Secondary_Quest_Rebellion_10_Scenario:	Title='', Desc=''
DLC1_Secondary_Quest_Swamp_01_EnterPrison:	Title='Quest/&DLC1_Secondary_Quest_Swamp_01_EnterPrison_Title', Desc=''
DLC1_Secondary_Quest_Swamp_01_FreeRugan:	Title='Quest/&DLC1_Secondary_Quest_Swamp_01_FreeRugan_Title', Desc=''
DLC1_Secondary_Quest_Swamp_01_Scenario:	Title='', Desc=''
DLC1_Secondary_Quest_Swamp_02:	Title='Quest/&DLC1_Secondary_Quest_Swamp_02_Title', Desc=''
DLC1_Secondary_Quest_Swamp_02_Scenario:	Title='', Desc=''
DLC1_Secondary_Quest_Swamp_03:	Title='Quest/&DLC1_Secondary_Quest_Swamp_03_Title', Desc=''
DLC1_Secondary_Quest_Swamp_03_Scenario:	Title='', Desc=''
DLC1_Secondary_Quest_ThePeople_05:	Title='Quest/&DLC1_Secondary_Quest_ThePeople_05_Title', Desc=''
DLC1_Secondary_Quest_ThePeople_06:	Title='Quest/&DLC1_Secondary_Quest_ThePeople_06_Title', Desc=''
DLC1_Secondary_Quest_ThePeople_07:	Title='Quest/&DLC1_Secondary_Quest_ThePeople_07_Title', Desc=''
DLC1_Secondary_Quest_ThePeople_08:	Title='Quest/&DLC1_Secondary_Quest_ThePeople_08_Title', Desc=''
DLC1_Secondary_Quest_ThePeople_09:	Title='Quest/&DLC1_Secondary_Quest_ThePeople_09_Title', Desc=''
DLC1_Secondary_Quest_ThePeople_10:	Title='Quest/&DLC1_Secondary_Quest_Swamp_ThePeople_10_Title', Desc=''
DLC1_Secondary_Quest_ThePeople_10_Scenario:	Title='Quest/&DLC1_Secondary_Quest_Swamp_ThePeople_10_Title', Desc=''
DLC1_Secondary_Quest_Valley_Forge_01:	Title='Quest/&DLC1_Secondary_Quest_Valley_Forge_01', Desc=''
DLC1_Secondary_Quest_Valley_Forge_02:	Title='Quest/&DLC1_Secondary_Quest_Forge_02_Title', Desc=''
DLC1_Secondary_Quest_Valley_Forge_03:	Title='Quest/&DLC1_Secondary_Quest_Valley_Forge_03', Desc=''
DLC1_Secondary_Quest_Valley_Giant_01:	Title='Quest/&DLC1_Secondary_Quest_Valley_Giant_01', Desc=''
DLC1_Secondary_Quest_Valley_Giant_02:	Title='Quest/&DLC1_Secondary_Quest_Valley_Giant_02', Desc=''
DLC1_Secondary_Quest_Valley_Giant_03:	Title='Quest/&DLC1_Secondary_Quest_Valley_Giant_03', Desc=''
DLC1_Secondary_Quest_Valley_Giant_04:	Title='Quest/&DLC1_Secondary_Quest_Valley_GIANT_04', Desc=''
DLC1_Secondary_Quest_Valley_Giant_05:	Title='Quest/&DLC1_Secondary_Quest_Valley_Giant_05', Desc=''
DLC1_Secondary_Quest_Valley_Giant_06:	Title='Quest/&DLC1_Secondary_Quest_Valley_Giant_06', Desc=''
DLC1_Secondary_Quest_Valley_Locked_Grotto:	Title='Quest/&DLC1_Secondary_Quest_Valley_Locked_Grotto', Desc=''
DLC1_Secondary_Quest_Valley_Mask_01:	Title='Quest/&DLC1_Secondary_Quest_Valley_Mask_01', Desc=''
DLC1_Secondary_Quest_Valley_Mask_02:	Title='Quest/&DLC1_Secondary_Quest_Valley_Mask_02', Desc=''
DLC1_Secondary_Quest_Valley_Mask_03:	Title='Quest/&DLC1_Secondary_Quest_Valley_Mask_03', Desc=''
DLC1_Secondary_Quest_Valley_Mask_11:	Title='Quest/&DLC1_Secondary_Quest_Valley_Mask_11', Desc=''
DLC1_Secondary_Quest_Valley_Underground_Ruins:	Title='Quest/&DLC1_Secondary_Quest_Valley_Underground_Ruins', Desc=''
DLC1_SUB_Scenario_City_Backup_PLAN_B:	Title='', Desc=''
DLC1_SUB_Scenario_City_Backup_PLAN_C:	Title='', Desc=''
DLC1_SUB_Scenario_City_Mask_04:	Title='Quest/&DLC1_Secondary_Quest_Valley_Mask_03', Desc=''
DLC1_SUB_Scenario_City_Mask_05:	Title='Quest/&DLC1_Secondary_Quest_Valley_Mask_03', Desc=''
DLC1_SUB_Scenario_City_Mask_06:	Title='Quest/&DLC1_Secondary_Quest_Valley_Mask_03', Desc=''
DLC1_SUB_Scenario_City_Mask_07:	Title='Quest/&DLC1_Secondary_Quest_Valley_Mask_07', Desc=''
DLC1_SUB_Scenario_City_Mask_08:	Title='Quest/&DLC1_Secondary_Quest_Valley_Mask_08', Desc=''
DLC1_SUB_Scenario_City_Mask_09:	Title='Quest/&DLC1_Secondary_Quest_Valley_Mask_09', Desc=''
DLC1_SUB_Scenario_City_Mask_11:	Title='Quest/&DLC1_Secondary_Quest_Valley_Mask_10', Desc=''
DLC1_SUB_Scenario_City_People_03:	Title='', Desc=''
DLC1_SUB_Scenario_City_People_04:	Title='', Desc=''
DLC1_SUB_Scenario_City_People_05:	Title='', Desc=''
DLC1_SUB_Scenario_City_People_06:	Title='', Desc=''
DLC1_SUB_Scenario_City_People_07:	Title='', Desc=''
DLC1_SUB_Scenario_City_People_08:	Title='', Desc=''
DLC1_SUB_Scenario_City_People_09:	Title='', Desc=''
DLC1_SUB_Scenario_Complex_01:	Title='', Desc=''
DLC1_SUB_Scenario_Complex_02:	Title='', Desc=''
DLC1_SUB_Scenario_Complex_03:	Title='', Desc=''
DLC1_SUB_Scenario_Complex_04:	Title='', Desc=''
DLC1_SUB_Scenario_Swamp_Forge_04:	Title='', Desc=''
DLC1_SUB_Scenario_Swamp_Forge_05:	Title='', Desc='Quest/&DLC1_Swamp_Orenetis_Apprentice_Quest_Description'
DLC1_SUB_Scenario_Swamp_Forge_06:	Title='', Desc='Quest/&DLC1_Swamp_Orenetis_Apprentice_Quest_Description'
DLC1_SUB_Scenario_Swamp_Forge_07:	Title='', Desc='Quest/&DLC1_Swamp_Orenetis_Apprentice_Quest_Description'
DLC1_SUB_Scenario_Swamp_Forge_08:	Title='', Desc='Quest/&DLC1_Swamp_Orenetis_Apprentice_Quest_Description'
DLC1_SUB_Scenario_Swamp_Forge_09:	Title='', Desc=''
DLC1_SUB_Scenario_Valley_Forge_01:	Title='', Desc=''
DLC1_SUB_Scenario_Valley_Forge_02:	Title='', Desc=''
DLC1_SUB_Scenario_Valley_Forge_03:	Title='', Desc=''
DLC1_SUB_Scenario_Valley_Giant_01:	Title='Quest/&DLC1_Secondary_Quest_Valley_Giant_01', Desc=''
DLC1_SUB_Scenario_Valley_Giant_02:	Title='Quest/&DLC1_Secondary_Quest_Valley_Giant_02', Desc=''
DLC1_SUB_Scenario_Valley_Giant_03:	Title='Quest/&DLC1_Secondary_Quest_Valley_Giant_03', Desc=''
DLC1_SUB_Scenario_Valley_Giant_04:	Title='Quest/&DLC1_Secondary_Quest_Valley_GIANT_04', Desc=''
DLC1_SUB_Scenario_Valley_Giant_05:	Title='Quest/&DLC1_Secondary_Quest_Valley_GIANT_05', Desc=''
DLC1_SUB_Scenario_Valley_Giant_06:	Title='DLC1_SUB_Scenario_Valley_Giant_03', Desc=''
DLC1_SUB_Scenario_Valley_Mask_01:	Title='Quest/&DLC1_Secondary_Quest_Valley_Mask_01', Desc=''
DLC1_SUB_Scenario_Valley_Mask_02:	Title='Quest/&DLC1_Secondary_Quest_Valley_Mask_02', Desc=''
DLC1_SUB_Scenario_Valley_Mask_03:	Title='Quest/&DLC1_Secondary_Quest_Valley_Mask_03', Desc=''
DLC1_SwampEncounterTable:	Title='', Desc=''
DLC1_ValleyEncounterTable:	Title='', Desc=''
DocumentTable:	Title='', Desc=''
DodgeTurned:	Title='', Desc=''
DragonCombatDecisions:	Title='', Desc=''
Drain_A:	Title='Prop/&DrainGrateTitle', Desc=''
Drain_B:	Title='Prop/&DrainGrateTitle', Desc=''
Drain_Big_24C_A:	Title='Room/&Room_Big_24CTitle', Desc=''
Drain_Big_24C_B:	Title='Room/&Room_Big_24CTitle', Desc=''
Drain_C:	Title='Prop/&DrainGrateTitle', Desc=''
Drain_Corner_12C:	Title='Room/&Corner_12CTitle', Desc=''
Drain_Crossroad_12C:	Title='Room/&Crossroad_12CTitle', Desc=''
Drain_Line_12C:	Title='Room/&Line_12CTitle', Desc=''
Drain_Line_24C:	Title='Room/&Line_24CTitle', Desc=''
Drain_Small_24C:	Title='Room/&Room_Small_24CTitle', Desc=''
Drain_Turn_12C:	Title='Room/&Turn_12CTitle', Desc=''
DrainGrate_A:	Title='Prop/&DrainGrateTitle', Desc=''
DrainGrate_B:	Title='Prop/&DrainGrateTitle', Desc=''
Dryad_Alternate_Presentation:	Title='', Desc=''
Dryad_Queen_Presentation:	Title='', Desc=''
DryadCombatDecisions:	Title='', Desc=''
DryadQueenCombatDecisions:	Title='', Desc=''
DryadWaterCombatDecisions:	Title='', Desc=''
Drying_Clothes_A:	Title='Prop/&Drying_ClothesTitle', Desc=''
Dull:	Title='VisualMood/&DullTitle', Desc=''
Eagle_Crow_Presentation:	Title='', Desc=''
Eagle_Giant_Presentation:	Title='', Desc=''
Earcorn:	Title='', Desc=''
Earcorn_01_Arriving:	Title='Campaign/&CrownOfTheMagister_Journal_DialogTitle_Earcorn_01_Arriving', Desc=''
Earcorn_01_Arriving_WithMerton:	Title='Campaign/&CrownOfTheMagister_Journal_DialogTitle_Earcorn_01_Arriving', Desc=''
Earcorn_02_Footsteps:	Title='Campaign/&CrownOfTheMagister_Journal_DialogTitle_Earcorn_02_Footsteps', Desc=''
Earcorn_02_Footsteps_WithMerton:	Title='Campaign/&CrownOfTheMagister_Journal_DialogTitle_Earcorn_02_Footsteps', Desc=''
Earcorn_03_AfterFight:	Title='Campaign/&CrownOfTheMagister_Journal_DialogTitle_Earcorn_03_AfterFight', Desc=''
Earcorn_03_AfterFight_WithMerton:	Title='Campaign/&CrownOfTheMagister_Journal_DialogTitle_Earcorn_03_AfterFight', Desc=''
Earcorn_04:	Title='', Desc=''
ElvenPalace:	Title='Prop/&PalaceTitle', Desc=''
Emote_Angry:	Title='', Desc=''
Empty:	Title='', Desc=''
EncounterLibrary_Scenario:	Title='', Desc=''
EncounterSpawn_PackMedium:	Title='', Desc=''
EncounterSpawn_PackMedium:	Title='', Desc=''
EncounterSpawn_PackSmall:	Title='', Desc=''
EncounterSpawn_PackSmall:	Title='', Desc=''
EncounterSpawn_PackSmall_PenalizeAltitude:	Title='', Desc=''
EncounterSpawn_PackSmall_PenalizeAltitude:	Title='', Desc=''
EncounterSpawn_Skirmisher:	Title='', Desc=''
EncounterSpawn_Skirmisher:	Title='', Desc=''
EncounterSpawn_Spread:	Title='', Desc=''
EncounterSpawn_Spread:	Title='', Desc=''
Evocation_01_Arriving:	Title='Campaign/&CrownOfTheMagister_Journal_DialogTitle_Evocation_01_Arriving', Desc=''
Evocation_02_FindingKebra:	Title='Campaign/&CrownOfTheMagister_Journal_DialogTitle_Evocation_02_FindingKebra', Desc=''
Evocation_02b_TalkToKebra:	Title='Campaign/&CrownOfTheMagister_Journal_DialogTitle_Evocation_02b_TalkToKebra', Desc=''
Evocation_03_EnterVolcano:	Title='Campaign/&CrownOfTheMagister_Journal_DialogTitle_Evocation_03_EnterVolcano', Desc=''
Evocation_04_TalkToArbal:	Title='Campaign/&CrownOfTheMagister_Journal_DialogTitle_Evocation_04_TalkToArbal', Desc=''
Evocation_05_Market:	Title='Campaign/&CrownOfTheMagister_Journal_DialogTitle_Evocation_05_Market', Desc=''
Evocation_06_SavedBrok:	Title='Campaign/&CrownOfTheMagister_Journal_DialogTitle_Evocation_06_SavedBrok', Desc=''
Evocation_07_Bloodspear:	Title='Campaign/&CrownOfTheMagister_Journal_DialogTitle_Evocation_07_Bloodspear', Desc=''
Evocation_08_Bloodspear_Edrof:	Title='Campaign/&CrownOfTheMagister_Journal_DialogTitle_Evocation_08_Bloodspear_Edrof', Desc=''
Evocation_09_Bloodspear_Victory:	Title='Campaign/&CrownOfTheMagister_Journal_DialogTitle_Evocation_09_Bloodspear_Victory', Desc=''
Evocation_10_Bladefang:	Title='Campaign/&CrownOfTheMagister_Journal_DialogTitle_Evocation_10_Bladefang', Desc=''
Evocation_11_Bladefang_Meeting:	Title='Campaign/&CrownOfTheMagister_Journal_DialogTitle_Evocation_11_Bladefang_Meeting', Desc=''
Evocation_12_Bladefangquest:	Title='Campaign/&CrownOfTheMagister_Journal_DialogTitle_Evocation_12_Bladefangquest', Desc=''
Evocation_13_OldQueen:	Title='Campaign/&CrownOfTheMagister_Journal_DialogTitle_Evocation_13_OldQueen', Desc=''
Evocation_14_OldQueenFight:	Title='Campaign/&CrownOfTheMagister_Journal_DialogTitle_Evocation_14_OldQueenFight', Desc=''
Evocation_15_OldQueenBeaten:	Title='Campaign/&CrownOfTheMagister_Journal_DialogTitle_Evocation_15_OldQueenBeaten', Desc=''
Evocation_16_ReturnHolyAxe:	Title='Campaign/&CrownOfTheMagister_Journal_DialogTitle_Evocation_16_ReturnHolyAxe', Desc=''
Evocation_17_Sandraven:	Title='Campaign/&CrownOfTheMagister_Journal_DialogTitle_Evocation_17_Sandraven', Desc=''
Evocation_18_Necropolis_Entrance:	Title='Campaign/&CrownOfTheMagister_Journal_DialogTitle_Evocation_18_Necropolis_Entrance', Desc=''
Evocation_19_Necropolis_Hall:	Title='Campaign/&CrownOfTheMagister_Journal_DialogTitle_Evocation_19_Necropolis_Hall', Desc=''
Evocation_20_Necropolis_Map:	Title='Campaign/&CrownOfTheMagister_Journal_DialogTitle_Evocation_20_Necropolis_Map', Desc=''
Evocation_21_Necropolis_Statue01:	Title='Campaign/&CrownOfTheMagister_Journal_DialogTitle_Evocation_21_Necropolis_Statue01', Desc=''
Evocation_22_Necropolis_Statue02:	Title='Campaign/&CrownOfTheMagister_Journal_DialogTitle_Evocation_22_Necropolis_Statue02', Desc=''
Evocation_23_Necropolis_Statue03:	Title='Campaign/&CrownOfTheMagister_Journal_DialogTitle_Evocation_23_Necropolis_Statue03', Desc=''
Evocation_24_Necropolis_Emperor:	Title='Campaign/&CrownOfTheMagister_Journal_DialogTitle_Evocation_24_Necropolis_Emperor', Desc=''
Evocation_25_Necropolis_AfterGhost:	Title='', Desc=''
Evocation_26_Necropolis_GhostReturn:	Title='Campaign/&CrownOfTheMagister_Journal_DialogTitle_Evocation_26_Necropolis_GhostReturn', Desc=''
Evocation_27_UrkaReveals:	Title='Campaign/&CrownOfTheMagister_Journal_DialogTitle_Evocation_27_UrkaReveals', Desc=''
Evocation_28_UrkaKilled:	Title='Campaign/&CrownOfTheMagister_Journal_DialogTitle_Evocation_28_UrkaKilled', Desc=''
Evocation_29_BackToBrok:	Title='Campaign/&CrownOfTheMagister_Journal_DialogTitle_Evocation_29_BackToBrok', Desc=''
Evocation_30_NearRedScarGate:	Title='Campaign/&CrownOfTheMagister_Journal_DialogTitle_Evocation_30_NearRedScarGate', Desc=''
Evocation_31_InsideCity:	Title='Campaign/&CrownOfTheMagister_Journal_DialogTitle_Evocation_31_InsideCity', Desc=''
Evocation_32_FacingArrok:	Title='Campaign/&CrownOfTheMagister_Journal_DialogTitle_Evocation_32_FacingArrok', Desc=''
Evocation_33_TribesUnite:	Title='Campaign/&CrownOfTheMagister_Journal_DialogTitle_Evocation_33_TribesUnite', Desc=''
Evocation_34_ArrokDefeated:	Title='Campaign/&CrownOfTheMagister_Journal_DialogTitle_Evocation_34_ArrokDefeated', Desc=''
Evocation_34_ArrokDefeated_Front:	Title='Campaign/&CrownOfTheMagister_Journal_DialogTitle_Evocation_34_ArrokDefeated', Desc=''
Evocation_35_Ending:	Title='Campaign/&CrownOfTheMagister_Journal_DialogTitle_Evocation_35_Ending', Desc=''
Faction_Banner_A:	Title='Prop/&BannerTitle', Desc=''
Faction_Banner_B:	Title='Prop/&BannerTitle', Desc=''
Faction_Banner_C:	Title='Prop/&BannerTitle', Desc=''
Faction_Banner_D:	Title='Prop/&BannerTitle', Desc=''
Faction_Banner_E:	Title='Prop/&BannerTitle', Desc=''
Faction_Banner_F:	Title='Prop/&BannerTitle', Desc=''
Faction_Banner_G:	Title='Prop/&BannerTitle', Desc=''
Faction_Banner_H:	Title='Prop/&BannerTitle', Desc=''
FactionDialog_Antiquarians_01:	Title='Campaign/&CrownOfTheMagister_Journal_DialogTitle_MeetHalmanSummer', Desc=''
FactionDialog_Antiquarians_02:	Title='Campaign/&CrownOfTheMagister_Journal_DialogTitle_VisitHalmanSummer', Desc=''
FactionDialog_Antiquarians_PickupQuest:	Title='', Desc=''
FactionDialog_Arcaneum_01:	Title='Campaign/&CrownOfTheMagister_Journal_DialogTitle_MeetHeddlonSurespell', Desc=''
FactionDialog_Arcaneum_02:	Title='Campaign/&CrownOfTheMagister_Journal_DialogTitle_VisitHeddlonSurespell', Desc=''
FactionDialog_Arcaneum_PickupQuest:	Title='Campaign/&CrownOfTheMagister_Journal_DialogTitle_VisitHeddlonSurespell', Desc=''
FactionDialog_Bartender_01:	Title='Campaign/&CrownOfTheMagister_Journal_DialogTitle_Karel', Desc=''
FactionDialog_CircleOfDanantar_01:	Title='Campaign/&CrownOfTheMagister_Journal_DialogTitle_MeetJorielFoxeye', Desc=''
FactionDialog_CircleOfDanantar_02:	Title='Campaign/&CrownOfTheMagister_Journal_DialogTitle_VisitJorielFoxeye', Desc=''
FactionDialog_CircleOfDanantar_PickupQuest:	Title='Campaign/&CrownOfTheMagister_Journal_DialogTitle_VisitJorielFoxeye', Desc=''
FactionDialog_DalonLark:	Title='Campaign/&CrownOfTheMagister_Journal_DialogTitle_PriestOfEinar', Desc=''
FactionDialog_DalonLark_Acolyte:	Title='Campaign/&CrownOfTheMagister_Journal_DialogTitle_PriestOfEinar', Desc=''
FactionDialog_DalonLark_PickupQuest:	Title='Campaign/&CrownOfTheMagister_Journal_DialogTitle_PriestOfEinar', Desc=''
FactionDialog_GorimIronsootGeneralStore:	Title='Campaign/&CrownOfTheMagister_Journal_DialogTitle_Gorim', Desc=''
FactionDialog_HugoRequerPotionShop:	Title='Campaign/&CrownOfTheMagister_Journal_DialogTitle_Hugo', Desc=''
FactionDialog_Scavengers_01:	Title='Campaign/&CrownOfTheMagister_Journal_DialogTitle_Annie01', Desc=''
FactionDialog_Scavengers_02:	Title='Campaign/&CrownOfTheMagister_Journal_DialogTitle_Annie02', Desc=''
FactionDialog_Scavengers_03_HenriksDeath:	Title='Campaign/&CrownOfTheMagister_Journal_DialogTitle_FactionDialog_Scavengers_03_HenriksDeath', Desc=''
FactionDialog_Scavengers_04_ClaimCaerLem:	Title='Campaign/&CrownOfTheMagister_Journal_DialogTitle_FactionDialog_Scavengers_04_ClaimCaerLem', Desc=''
FactionDialog_Scavengers_05_save:	Title='Campaign/&CrownOfTheMagister_Journal_DialogTitle_Annie02', Desc=''
FactionDialog_Scavengers_05_WhosArwinMerton:	Title='Campaign/&CrownOfTheMagister_Journal_DialogTitle_FactionDialog_Scavengers_05_WhosArwinMerton', Desc=''
FactionDialog_Scavengers_06_StartAcademicQuest:	Title='Campaign/&CrownOfTheMagister_Journal_DialogTitle_FactionDialog_Scavengers_06_StartAcademicQuest', Desc=''
FactionDialog_Scavengers_07_StartLowlifeQuest:	Title='Campaign/&CrownOfTheMagister_Journal_DialogTitle_FactionDialog_Scavengers_07_StartLowlifeQuest', Desc=''
FactionDialog_Scavengers_08_EndLowlifeQuest:	Title='Campaign/&CrownOfTheMagister_Journal_DialogTitle_FactionDialog_Scavengers_08_EndLowlifeQuest', Desc=''
FactionDialog_Scavengers_09_StartSellswordQuest:	Title='Campaign/&CrownOfTheMagister_Journal_DialogTitle_FactionDialog_Scavengers_09_StartSellswordQuest', Desc=''
FactionDialog_TowerOfKnowledge_01:	Title='Campaign/&CrownOfTheMagister_Journal_DialogTitle_MeetMaddyGreenisle', Desc=''
FactionDialog_TowerOfKnowledge_02:	Title='Campaign/&CrownOfTheMagister_Journal_DialogTitle_VisitMaddyGreenisle', Desc=''
FactionDialog_TowerOfKnowledge_PickupQuest:	Title='Campaign/&CrownOfTheMagister_Journal_DialogTitle_VisitMaddyGreenisle', Desc=''
Farmhouse:	Title='', Desc=''
Fear:	Title='', Desc=''
Fence_A:	Title='Prop/&WoodFenceTitle', Desc=''
Fence_B:	Title='Prop/&WoodFenceTitle', Desc=''
Fence_Post:	Title='Prop/&WoodFenceTitle', Desc=''
FighterCombatDecisions:	Title='', Desc=''
FireBasin_A:	Title='Prop/&FireBasinTitle', Desc=''
FireBasin_B:	Title='Prop/&FireBasinTitle', Desc=''
FireOspreyCombatDecisions:	Title='', Desc=''
Fireplace:	Title='Prop/&FireplaceTitle', Desc=''
FireplaceTavern:	Title='Prop/&FireplaceTitle', Desc=''
FlagTavern:	Title='Prop/&BannerTitle', Desc=''
FlyingSnakeCombatDecisions:	Title='', Desc=''
Fountain_A:	Title='Prop/&FountainTitle', Desc=''
Fountain_B:	Title='Prop/&FountainTitle', Desc=''
Gallow:	Title='Prop/&GallowTitle', Desc=''
Garden_Arch:	Title='Prop/&ArchTitle', Desc=''
Garden_Flowerbed_Corner_A:	Title='Prop/&Flowers_PatchTitle', Desc=''
Garden_Flowerbed_Line_A:	Title='Prop/&Flowerbed_LineTitle', Desc=''
Garden_Ground_A:	Title='Prop/&Garden_GroundTitle', Desc=''
Garden_Hedge_Corner:	Title='Prop/&Garden_HedgeTitle', Desc=''
Garden_Kiosk:	Title='Prop/&KioskTitle', Desc=''
Garden_Square_Statue:	Title='Prop/&StatueTitle', Desc=''
Garden_Stone_Bench:	Title='Prop/&BenchTitle', Desc=''
Garden_Wall:	Title='Prop/&WallSimpleTitle', Desc=''
Garden_Wall_End:	Title='Prop/&WallSimpleTitle', Desc=''
Garden_Wall_Juniper_B:	Title='Prop/&Wall_CreeperTitle', Desc=''
Generic_Necromancer_CombatDecisions:	Title='', Desc=''
GhastCombatDecisions:	Title='', Desc=''
GhostCombatDecisions:	Title='', Desc=''
GhoulCombatDecisions:	Title='', Desc=''
Giant_Ape_Mutant_Presentation:	Title='', Desc=''
Giant_Ape_Presentation:	Title='', Desc=''
Giant_Beetle_Presentation_Basic:	Title='', Desc=''
Giant_Fire_Presentation:	Title='', Desc=''
Giant_Hill_Presentation:	Title='', Desc=''
Giant_Hill_Presentation_Gortek:	Title='', Desc=''
Giant_Hill_Presentation_Rugan:	Title='', Desc=''
GiantSpiderCombatDecisions:	Title='', Desc=''
Globe:	Title='Prop/&GlobeTitle', Desc=''
Gloomy:	Title='VisualMood/&GloomyTitle', Desc=''
GoblinBecomesSkirmisher:	Title='', Desc=''
GoblinCombatDecisions:	Title='', Desc=''
GoblinShamanCombatDecisions:	Title='', Desc=''
GoblinSkirmisherCombatDecisions:	Title='', Desc=''
Gold_Dragon_Presentation:	Title='', Desc=''
Golden:	Title='VisualMood/&GoldenTitle', Desc=''
Golem_Clay_Presentation:	Title='', Desc=''
Golem_Iron_Presentation:	Title='', Desc=''
Green_Dragon_Presentation:	Title='', Desc=''
GreenHagCombatDecisions:	Title='', Desc=''
Greenhouse_A:	Title='Prop/&GreenHouseTitle', Desc=''
Greenhouse_B:	Title='Prop/&GreenHouseTitle', Desc=''
Greenhouse_C:	Title='Prop/&GreenHouseTitle', Desc=''
Greenish:	Title='VisualMood/&GreenishTitle', Desc=''
Hag_Night_Presentation:	Title='', Desc=''
Hallway_12C:	Title='Room/&Hallway_12CTitle', Desc=''
Harp:	Title='Prop/&HarpTitle', Desc=''
HayStack_A:	Title='Prop/&HayStackTitle', Desc=''
HayStack_B:	Title='Prop/&HayStackTitle', Desc=''
HiddenCaves_BridgeOverCliff_01_CollapsedCity:	Title='', Desc=''
HiddenCaves_CaveStart_01_CaveEntrance:	Title='', Desc=''
HiddenCaves_CaveStart_02_SeingOrcs:	Title='', Desc=''
HiddenCaves_Corridor_01_ImperialStatue5:	Title='', Desc=''
HiddenCaves_Crypt_01_Tomb1:	Title='', Desc=''
HiddenCaves_Crypt_02_Tomb2:	Title='', Desc=''
HiddenCaves_Crypt_03_Tomb3:	Title='', Desc=''
HiddenCaves_Crypt_04_MagicMouth:	Title='', Desc=''
HiddenCaves_CryptVestibule_01_ImperialStatue1:	Title='', Desc=''
HiddenCaves_CryptVestibule_02_ImperialStatue2:	Title='', Desc=''
HiddenCaves_CryptVestibule_03_ImperialStatue3:	Title='', Desc=''
HiddenCaves_CryptVestibule_04_ImperialStatue4:	Title='', Desc=''
HiddenCaves_CryptVestibule_05_TapestryMap:	Title='', Desc=''
HiddenCaves_CultistAtrium_01_AtriumEntrance:	Title='', Desc=''
HiddenCaves_CultistAtrium_02_CryptDoor:	Title='', Desc=''
HiddenCaves_CultistAtrium_03_CultistDoor:	Title='', Desc=''
HiddenCaves_LordTomb_01_EmperorTomb:	Title='', Desc=''
HiddenCaves_OrcCampRoom_01_CampEntrance:	Title='', Desc=''
HiddenCaves_OrcsGuards_01_DialogOrcGatekeeper:	Title='', Desc=''
House_A:	Title='Prop/&HouseTitle', Desc=''
House_B:	Title='Prop/&HouseTitle', Desc=''
House_C:	Title='Prop/&HouseTitle', Desc=''
House_D:	Title='Prop/&HouseTitle', Desc=''
House_E:	Title='Prop/&HouseTitle', Desc=''
House_F:	Title='Prop/&HouseTitle', Desc=''
House_G:	Title='Prop/&HouseTitle', Desc=''
House_H:	Title='Prop/&HouseTitle', Desc=''
HuntingGrounds:	Title='', Desc=''
Hut:	Title='Prop/&HutTitle', Desc=''
Idle:	Title='', Desc=''
IdleGuard_Default:	Title='', Desc=''
IdleGuard_Default_CanAttackNPC:	Title='', Desc=''
IdleGuard_NoIntercept:	Title='', Desc=''
IdleGuard_Tutorial:	Title='', Desc=''
Inferno:	Title='VisualMood/&InfernoTitle', Desc=''
Information_Board_A:	Title='Prop/&Information_BoardTitle', Desc=''
Information_Board_B:	Title='Prop/&Information_BoardTitle', Desc=''
Intercept:	Title='', Desc=''
Intercept_CanTargetNPC:	Title='', Desc=''
Introduction_Inn_01_Camera_Calibration:	Title='', Desc=''
Introduction_Inn_01_CarranArrives:	Title='', Desc=''
Introduction_Inn_01_NEW:	Title='Campaign/&CrownOfTheMagister_Journal_DialogTitle_AfterTuto0', Desc=''
Introduction_Inn_02_After_Tutorial_1:	Title='', Desc=''
Introduction_Inn_03_After_Tutorial_2:	Title='', Desc=''
Introduction_Inn_03_AfterTutoWolves_NEW:	Title='Campaign/&CrownOfTheMagister_Journal_DialogTitle_AfterTuto2', Desc=''
Introduction_Inn_04_After_Tutorial_3:	Title='', Desc=''
Introduction_Inn_04_AfterTutoOrcHideout_NEW:	Title='Campaign/&CrownOfTheMagister_Journal_DialogTitle_AfterTuto3', Desc=''
Introduction_Inn_05_AfterTutoStealthFort_NEW:	Title='Campaign/&CrownOfTheMagister_Journal_DialogTitle_AfterTuto4', Desc=''
Introduction_Inn_05_AfterTutoStealthFort_NEW_SAVE:	Title='', Desc=''
Introduction_Inn_05_AfterTutoStealthFort_NEW_TEST:	Title='Campaign/&CrownOfTheMagister_Journal_DialogTitle_AfterTuto4', Desc=''
Introduction_Inn_05_Tutorial_4:	Title='', Desc=''
Introduction_Inn_06_Tutorial_End:	Title='', Desc=''
Introduction_Inn_07_CarranSystemic:	Title='', Desc=''
IntroLore:	Title='', Desc=''
IntroOffice_NarrativeTree:	Title='', Desc=''
IntWall_A:	Title='Prop/&WallSimpleTitle', Desc=''
IntWall_B:	Title='Prop/&WallSimpleTitle', Desc=''
IntWall_C:	Title='Prop/&WallSimpleTitle', Desc=''
IntWall_Crawl:	Title='Prop/&WallCrawl', Desc=''
IntWall_D:	Title='Prop/&WallSimpleTitle', Desc=''
IntWall_Thin_A:	Title='Prop/&WallThinTitle', Desc=''
IntWall_Thin_A2:	Title='Prop/&WallThinTitle', Desc=''
IntWall_Thin_B:	Title='Prop/&WallThinTitle', Desc=''
IntWall_Thin_B2:	Title='Prop/&WallThinTitle', Desc=''
IntWall_Thin_C:	Title='Prop/&WallThinTitle', Desc=''
IntWall_Thin_C2:	Title='Prop/&WallThinTitle', Desc=''
IntWall_Thin_Door:	Title='Prop/&WallThinTitle', Desc=''
IntWall_Thin_Separator:	Title='Prop/&WallThinTitle', Desc=''
IntWall_ThinCracked_A:	Title='Prop/&WallCrawl', Desc=''
IntWall_ThinCracked_A2:	Title='Prop/&WallCrawl', Desc=''
IntWall_ThinCracked_B:	Title='Prop/&WallCrawl', Desc=''
IntWall_ThinCracked_B2:	Title='Prop/&WallCrawl', Desc=''
ItemFlag_Corrosive:	Title='', Desc='Equipment/&ItemFlag_Corrosive_Description'
ItemFlag_Flaming:	Title='', Desc='Equipment/&ItemFlag_Flaming_Description'
ItemFlag_Flash:	Title='', Desc='Equipment/&ItemFlag_Flash_Description'
ItemFlagIngredient_Component:	Title='', Desc='Equipment/&ItemFlagIngredientDescription'
ItemFlagIngredient_Enchant:	Title='', Desc='Equipment/&ItemFlagIngredientDescription'
ItemFlagPoison_1D4:	Title='', Desc='Equipment/&ItemFlagPoison_1D4_Description'
ItemFlagPoison_1D6:	Title='', Desc='Equipment/&ItemFlagPoison_1D6_Description'
ItemFlagPoison_1D8:	Title='', Desc='Equipment/&ItemFlagPoison_1D8_Description'
ItemFlagPoison_2D4:	Title='', Desc='Equipment/&ItemFlagPoison_2D4_Description'
ItemFlagPoison_2D8:	Title='', Desc='Equipment/&ItemFlagPoison_2D8_Description'
ItemFlagPoison_3D6:	Title='', Desc='Equipment/&ItemFlagPoison_3D6_Description'
ItemFlagPoison_3D8:	Title='', Desc='Equipment/&ItemFlagPoison_3D8_Description'
ItemFlagPoison_Blinding:	Title='', Desc='Equipment/&ItemFlagPoison_Blinded_Description'
ItemFlagPoison_Condition_Poisoned:	Title='', Desc='Equipment/&ItemFlagPoison_Poisoned_Description'
ItemFlagPoison_Overtime:	Title='', Desc='Equipment/&ItemFlagPoison_Overtime_Description'
ItemFlagPoison_Paralyzing:	Title='', Desc='Equipment/&ItemFlagPoison_Paralyzed_Description'
ItemFlagPoison_Restrained:	Title='', Desc='Equipment/&ItemFlagPoison_Restrained_Description'
ItemFlagPrimed:	Title='', Desc='Equipment/&ItemFlagPrimedDescription'
ItemFlagQuest:	Title='', Desc='Equipment/&ItemFlagQuestDescription'
JungleVillage:	Title='', Desc=''
JuniperGround_A:	Title='Prop/&JuniperGroundTitle', Desc=''
Kickstarter_01_Arriving:	Title='Narration/&TelemaArrivingTitle', Desc=''
Kickstarter_02_Scavengers:	Title='Narration/&TelemaMeetingScavsTitle', Desc=''
Kickstarter_02_Scavengers Backup:	Title='Narration/&TelemaMeetingScavsTitle', Desc=''
Kickstarter_02_Scavengers_Revamp:	Title='Narration/&TelemaMeetingScavsTitle', Desc=''
Kickstarter_03_BasRelief:	Title='Narration/&TelemaBasReliefTitle', Desc=''
Kickstarter_04_Chest:	Title='Narration/&TelemaChestTitle', Desc=''
Kickstarter_05_Statue:	Title='Narration/&TelemaStatueTitle', Desc=''
Kickstarter_06_LockedDoor:	Title='Narration/&TelemaDoorTitle', Desc=''
Kickstarter_07_Crawl:	Title='', Desc=''
Kickstarter_08_OrcRoom_01:	Title='', Desc=''
Kickstarter_09_OrcRoom_02:	Title='Narration/&TelemaBackFromReconTitle', Desc=''
Kickstarter_10_OrcRoom_03:	Title='Narration/&TelemaOrcCampExitTitle', Desc=''
Kickstarter_10B_VerticalRoom_DoorPlan:	Title='', Desc=''
Kickstarter_11_VerticalRoom:	Title='Narration/&TelemaVerticalEntranceTitle', Desc=''
Kickstarter_12_VerticalRoomEnd:	Title='Narration/&TelemaVerticalExitTitle', Desc=''
Kickstarter_13_SpiderNest_01:	Title='Narration/&TelemaShaftEntranceTitle', Desc=''
Kickstarter_14_SpiderNest_02:	Title='Narration/&TelemaShaftUpperTitle', Desc=''
Kickstarter_14_SpiderNest_03:	Title='', Desc=''
Kickstarter_15_FoundHector:	Title='Narration/&TelemaShaftCollapsedTitle', Desc=''
Kickstarter_16_TalkToHector:	Title='', Desc=''
Kickstarter_17_AfterRest:	Title='', Desc=''
Kickstarter_18_Orcs:	Title='', Desc=''
Kickstarter_19_BackToRuins:	Title='', Desc=''
Kickstarter_20_LibraryFound:	Title='', Desc=''
Kickstarter_21_End:	Title='', Desc=''
KillRazanCompatibilityScenario:	Title='', Desc=''
Ladder:	Title='Prop/&LadderTitle', Desc=''
LavaBasin_A:	Title='Prop/&LavaBasinTitle', Desc=''
LavaBasin_B:	Title='Prop/&LavaBasinTitle', Desc=''
LavaBasin_C:	Title='Prop/&LavaBasinTitle', Desc=''
LavaForest:	Title='', Desc=''
LegendaryAoE_Debuff:	Title='', Desc=''
LegendaryAoE_DpS:	Title='', Desc=''
LegendaryDefilerAoE_Debuff:	Title='', Desc=''
LegendaryDefilerAoE_DpS:	Title='', Desc=''
LegendaryDefilerAttack:	Title='', Desc=''
LegendaryDefilerDarkness:	Title='', Desc=''
LegendaryDefilerLifeLeechAlly:	Title='', Desc=''
LegendaryDragonAttack:	Title='', Desc=''
LegendaryDragonWingAttack:	Title='', Desc=''
LegendaryLaetharCast_Debuff:	Title='', Desc=''
LegendaryLaetharCast_Teleport:	Title='', Desc=''
LegendaryMummyLordAoE_Debuff_BlasphemousWord:	Title='', Desc=''
LegendaryMummyLordAoE_Debuff_BlindingDust:	Title='', Desc=''
LegendaryMummyLordAoE_Debuff_ChannelNegativeEnergy:	Title='', Desc=''
LegendaryMummyLordAttack_Default:	Title='', Desc=''
LegendaryMummyLordCast_Debuff:	Title='', Desc=''
LegendaryMummyLordCast_Teleport:	Title='', Desc=''
LegendaryQuest_Quest:	Title='Quest/&LegendaryQuest_Title', Desc=''
LegendaryQuest_Scenario:	Title='Legendary Quest', Desc=''
LegendaryQuest_Scenario_ChangeMerton:	Title='To start the quest on the pickup board', Desc=''
LegendaryQuest_Scenario_Trigger:	Title='To start the quest on the pickup board', Desc=''
LegendarySorakAoE_Debuff:	Title='', Desc=''
LegendarySorakAoE_DpS:	Title='', Desc=''
LegendarySorakAttack_Default:	Title='', Desc=''
LegendarySorakAttack_TouchOfDarkness:	Title='', Desc=''
LegendarySpiderQueenAoE_Debuff:	Title='', Desc=''
LegendarySpiderQueenAoE_DpS:	Title='', Desc=''
LegendarySpiderQueenAttack:	Title='', Desc=''
LegendarySpiderQueenLifeLeechAlly:	Title='', Desc=''
Level_01_CaerLem_01:	Title='Campaign/&CrownOfTheMagister_Journal_DialogTitle_CaerLem01', Desc=''
Level_01_CaerLem_02:	Title='Campaign/&CrownOfTheMagister_Journal_DialogTitle_CaerLem02', Desc=''
Level_01_CaerLem_03:	Title='Campaign/&CrownOfTheMagister_Journal_DialogTitle_CaerLem03', Desc=''
Level_01_CaerLem_04_TowerTop:	Title='Campaign/&CrownOfTheMagister_Journal_DialogTitle_CaerLem04', Desc=''
Level_01_CaerLem_04_TowerTop_Outside:	Title='Campaign/&CrownOfTheMagister_Journal_DialogTitle_CaerLem05', Desc=''
Level_01_CaerLem_08_Darik_1:	Title='Campaign/&CrownOfTheMagister_Journal_DialogTitle_CaerLem06', Desc=''
Level_01_CaerLem_09_Robar_1:	Title='Campaign/&CrownOfTheMagister_Journal_DialogTitle_CaerLem07', Desc=''
Level_01_CaerLem_10_Lisbath_1:	Title='Campaign/&CrownOfTheMagister_Journal_DialogTitle_CaerLem08', Desc=''
Level_01_CaerLem_11_Internal:	Title='Campaign/&CrownOfTheMagister_Journal_DialogTitle_CaerLem09', Desc=''
Level_01_CaerLem_12_Robar_2:	Title='Campaign/&CrownOfTheMagister_Journal_DialogTitle_CaerLem10', Desc=''
Level_01_CaerLem_13_Darik_2:	Title='Campaign/&CrownOfTheMagister_Journal_DialogTitle_CaerLem10', Desc=''
Level_01_CaerLem_14_DarikIsKilled:	Title='Campaign/&CrownOfTheMagister_Journal_DialogTitle_CaerLem10', Desc=''
Level_01_CaerLem_15_Beryl_2:	Title='Campaign/&CrownOfTheMagister_Journal_DialogTitle_CaerLem10', Desc=''
Level_01_CaerLem_16_RobarIsKilled:	Title='Campaign/&CrownOfTheMagister_Journal_DialogTitle_CaerLem10', Desc=''
Level_01_CaerLem_17_LisbathlIsKilled:	Title='Campaign/&CrownOfTheMagister_Journal_DialogTitle_CaerLem10', Desc=''
Level_01_CaerLem_18_BerylIsKilled:	Title='Campaign/&CrownOfTheMagister_Journal_DialogTitle_CaerLem10', Desc=''
Level_01_CaerLem_20_Final:	Title='Campaign/&CrownOfTheMagister_Journal_DialogTitle_CaerLem11', Desc=''
Level_01_CaerLem_21_InspectTower:	Title='Campaign/&CrownOfTheMagister_Journal_DialogTitle_CaerLemGeneric', Desc=''
Level_01_CaerLem_22_InspectGate:	Title='Campaign/&CrownOfTheMagister_Journal_DialogTitle_CaerLemGeneric', Desc=''
Level_01_CaerLem_Caves_01_Daliat_Flees:	Title='Campaign/&CrownOfTheMagister_Journal_DialogTitle_CaerLem12', Desc=''
Level_01_CaerLem_Caves_01_Lisbath_Stayed:	Title='Campaign/&CrownOfTheMagister_Journal_DialogTitle_CaerLem12', Desc=''
Level_01_CaerLem_Caves_02_See_Enemies:	Title='Campaign/&CrownOfTheMagister_Journal_DialogTitle_CaerLem13', Desc=''
Level_01_CaerLem_Caves_03_InspectCorpse:	Title='Campaign/&CrownOfTheMagister_Journal_DialogTitle_CaerLemGeneric', Desc=''
Level_01_CaerLem_Caves_04_InspectTirmarian:	Title='Campaign/&CrownOfTheMagister_Journal_DialogTitle_CaerLemGeneric', Desc=''
Level_01_CaerLem_Caves_05_Exit_Caer_Lem:	Title='Campaign/&CrownOfTheMagister_Journal_DialogTitle_CaerLem14', Desc=''
Level_01_CaerLem_Caves_Bridge_01:	Title='', Desc=''
Level_01_CaerLem_Caves_Bridge_02:	Title='', Desc=''
Level_01_CaerLem_TP:	Title='', Desc=''
Level1_Druid_Brek:	Title='', Desc=''
LightAffinity_Defiler_Darkness:	Title='', Desc=''
LightAffinityHypersensitivity:	Title='', Desc=''
LightAffinityLightSensitivity:	Title='', Desc=''
Line_12C:	Title='Room/&Line_12CTitle', Desc=''
Line_24C:	Title='Room/&Line_24CTitle', Desc=''
Line_Mausoleum_12C:	Title='Room/&Line_12CTitle', Desc=''
Lodge_A:	Title='Prop/&HutTitle', Desc=''
Lodge_B:	Title='Prop/&HutTitle', Desc=''
Logs_A:	Title='Prop/&LogsTitle', Desc=''
Logs_B:	Title='Prop/&LogsTitle', Desc=''
LongRangePathToEnemy_Dash:	Title='', Desc=''
LongRangePathToEnemy_DashAvoidLight:	Title='', Desc=''
LongRangePathToEnemy_NoDash:	Title='', Desc=''
LongRangePathToEnemyOnlyIfNoAction_Dash:	Title='', Desc=''
Lovely:	Title='VisualMood/&LovelyTitle', Desc=''
LowGround_Big_24C:	Title='Room/&Room_Big_24CTitle', Desc=''
LowGround_Crossroad_12C:	Title='Room/&Crossroad_12CTitle', Desc=''
LowGround_Small_24C:	Title='Room/&Room_Small_24CTitle', Desc=''
ManholeCover_B:	Title='Prop/&ManholeCoverTitle', Desc=''
Mansion:	Title='', Desc=''
Map_Badlands:	Title='NamedPlace/&BADLANDS_Title', Desc=''
Map_Copperhead_Road:	Title='NamedPlace/&CopperheadRoad_Title', Desc=''
Map_DLC1_City:	Title='NamedPlace/&City_Title', Desc=''
Map_DLC1_Jungle:	Title='NamedPlace/&Jungle_Title', Desc=''
Map_DLC1_Marches:	Title='NamedPlace/&MARCHES_Title', Desc=''
Map_DLC1_Swamps:	Title='NamedPlace/&Swamp_Title', Desc=''
Map_Duchy_Caer_Cyflen:	Title='NamedPlace/&DUCHY_caercyflen_Title', Desc=''
Map_Duchy_Eastern_Forests:	Title='NamedPlace/&DUCHY_easternforests_Title', Desc=''
Map_Duchy_Northern_Hills:	Title='NamedPlace/&DUCHY_northernhills_Title', Desc=''
Map_Duchy_Northern_Plains:	Title='NamedPlace/&DUCHY_northernplains_Title', Desc=''
Map_Duchy_South_Marsh:	Title='NamedPlace/&DUCHY_southmarsh_Title', Desc=''
Map_Duchy_Western_Fields:	Title='NamedPlace/&DUCHY_westernfields_Title', Desc=''
Map_Einarium:	Title='NamedPlace/&Einarium_Title', Desc=''
Map_Gallivan_Title:	Title='NamedPlace/&GALLIVAN_Title', Desc=''
Map_Kaupaapunki:	Title='NamedPlace/&Kaupaapunki_Title', Desc=''
Map_New_Empire_Title:	Title='NamedPlace/&NEWEMPIRE_Title', Desc=''
Map_Principality_Title:	Title='NamedPlace/&MASGARTH_Title', Desc=''
Map_Sandreed:	Title='NamedPlace/&Sandreed_Title', Desc=''
Map_Snow_Alliance_Title:	Title='NamedPlace/&SNOWALLIANCE_Title', Desc=''
Map_TheAerElai:	Title='NamedPlace/&AerElai_Title', Desc=''
MapWaypointDefinition_Aer_Elai_Final_AcidLake:	Title='Map/&Location_AerElaiFinal_AcidLake', Desc=''
MapWaypointDefinition_Aer_Elai_Final_BentPalace:	Title='Map/&Location_AerElaiFinal_BentPalace', Desc=''
MapWaypointDefinition_Aer_Elai_Final_BoneYard:	Title='Map/&Location_AerElaiFinal_BoneYard', Desc=''
MapWaypointDefinition_Aer_Elai_Final_Gate:	Title='Map/&Location_AerElaiFinal_ImperialGate', Desc=''
MapWaypointDefinition_Aer_Elai_Final_LavaFall:	Title='Map/&Location_AerElaiFinal_LaveFall', Desc=''
MapWaypointDefinition_Aer_Elai_Final_MistyPath:	Title='Map/&Location_AerElaiFinal_MistyPath', Desc=''
MapWaypointDefinition_Aer_Elai_Final_TheRift:	Title='Map/&Location_AerElaiFinal_TheRift', Desc=''
MapWaypointDefinition_BoneKeep_Castle:	Title='Map/&Location_BoneKeep_Castle_Title', Desc=''
MapWaypointDefinition_BoneKeep_Cemetery:	Title='Map/&Location_BoneKeep_Cemetery_Title', Desc=''
MapWaypointDefinition_BoneKeep_Courtyard:	Title='Map/&Location_BoneKeep_Courtyard_Title', Desc=''
MapWaypointDefinition_BoneKeep_DrainPipe:	Title='Map/&Location_BoneKeep_DrainPipe_Title', Desc=''
MapWaypointDefinition_BoneKeep_DrainPipe_Courtyard_Access:	Title='Map/&Location_BoneKeep_DrainPipeCourtyard_Title', Desc=''
MapWaypointDefinition_BoneKeep_DrainPipe_StoreHouse_Access:	Title='Map/&Location_BoneKeep_DrainPipeStoreHouse_Title', Desc=''
MapWaypointDefinition_BoneKeep_DrainPipe_Well_Access:	Title='Map/&Location_BoneKeep_DrainPipeWell_Title', Desc=''
MapWaypointDefinition_BoneKeep_Laboratory:	Title='Map/&Location_BoneKeep_Laboratory_Title', Desc=''
MapWaypointDefinition_BoneKeep_Laboratory_Access:	Title='Map/&Location_BoneKeep_Laboratory_Access_Title', Desc=''
MapWaypointDefinition_BoneKeep_Laboratory_ToLair:	Title='Map/&Location_BoneKeep_Laboratory_ToLair', Desc=''
MapWaypointDefinition_BoneKeep_Lair_Access:	Title='Map/&Location_Lair_Access_Title', Desc=''
MapWaypointDefinition_BoneKeep_Lair_AkshasRoom:	Title='Map/&Location_Lair_AkshasRoom_Title', Desc=''
MapWaypointDefinition_BoneKeep_Pond:	Title='Map/&Location_BoneKeep_Pond_Title', Desc=''
MapWaypointDefinition_BoneKeep_Sewers:	Title='Map/&Location_BoneKeep_Sewers_Title', Desc=''
MapWaypointDefinition_BoneKeep_Solar_Access:	Title='Map/&Location_BoneKeep_Solar_Access_Title', Desc=''
MapWaypointDefinition_BoneKeep_Solar_Quarters:	Title='Map/&Location_BoneKeep_Solar_Title', Desc=''
MapWaypointDefinition_BoneKeep_Solar_Tower:	Title='Map/&Location_BoneKeep_Solar_Tower_Title', Desc=''
MapWaypointDefinition_BoneKeep_Teleporter:	Title='Map/&Location_BoneKeep_Teleporter_Title', Desc=''
MapWaypointDefinition_CaerCyflen_Council:	Title='Map/&Location_CCyflen_Council_Title', Desc=''
MapWaypointDefinition_CaerCyflen_DeadEnd:	Title='Map/&Location_CCyflen_DeadEnd_Title', Desc=''
MapWaypointDefinition_CaerCyflen_Exit:	Title='Map/&Location_CCyflen_Exit_Title', Desc=''
MapWaypointDefinition_CaerCyflen_GallivanEmbassy:	Title='Map/&Location_Gallivan_Embassy_Title', Desc=''
MapWaypointDefinition_CaerCyflen_MajorGate:	Title='Map/&Location_Coparann_Teleporter_Title', Desc=''
MapWaypointDefinition_CaerCyflen_MarketStreet:	Title='Map/&Location_CCyflen_MarketStreet_Title', Desc=''
MapWaypointDefinition_CaerCyflen_NewEmpireEmbassy:	Title='Location/&NPEmbassy_Title', Desc=''
MapWaypointDefinition_CaerCyflen_PhilosopherHouse:	Title='Map/&Location_CCyflen_PhilosopherHouse_Title', Desc=''
MapWaypointDefinition_CaerCyflen_Plaza:	Title='Map/&Location_CCyflen_Plaza_Title', Desc=''
MapWaypointDefinition_CaerCyflen_Promontory:	Title='Map/&Location_CCyflen_Promontory_Title', Desc=''
MapWaypointDefinition_CaerCyflen_SnowAllianceEmbassy:	Title='Map/&Location_CCyflen_SnowAllianceEmbassy_Title', Desc=''
MapWaypointDefinition_CaerCyflen_Tavern:	Title='Map/&Location_CCyflen_Tavern_Title', Desc=''
MapWaypointDefinition_CaerCyflen_Temple_Exit:	Title='Map/&Location_CCyflen_Temple_Exit_Title', Desc=''
MapWaypointDefinition_CaerCyflen_Temple_Misaye:	Title='Map/&Location_CCyflen_Temple_Misaye_Title', Desc=''
MapWaypointDefinition_CaerCyflen_Temples:	Title='Map/&Location_CCyflen_TemplesQuarter_Title', Desc=''
MapWaypointDefinition_CaerLem_Bridge:	Title='Map/&Location_CaerLem_BridgeTitle', Desc=''
MapWaypointDefinition_CaerLem_Exit:	Title='Map/&Location_CaerLem_Exit_Title', Desc=''
MapWaypointDefinition_CaerLem_GoblinCave:	Title='Map/&Location_CaerLem_GoblinCave_Title', Desc=''
MapWaypointDefinition_CaerLem_InnerFort:	Title='Map/&Location_CaerLem_InnerFort_Title', Desc=''
MapWaypointDefinition_CaerLem_Library:	Title='Map/&Location_CaerLem_LibraryTitle', Desc=''
MapWaypointDefinition_CaerLem_LONG_REST_AREA:	Title='Map/&Location_Generic_Long_Rest_Area_Title', Desc=''
MapWaypointDefinition_CaerLem_Mushrooms:	Title='Map/&Location_CaerLem_MushroomsTitle', Desc=''
MapWaypointDefinition_CaerLem_SecretCaves:	Title='Map/&Location_CaerLem_SecretCavesTitle', Desc=''
MapWaypointDefinition_CaerLem_SoraksCamp:	Title='Map/&Location_CaerLem_SoraksCampTitle', Desc=''
MapWaypointDefinition_CaerLem_TirmarianTower:	Title='Location/&TirmarianTower_Title', Desc=''
MapWaypointDefinition_CaerLem_Tower:	Title='Map/&Location_CaerLem_Tower_Title', Desc=''
MapWaypointDefinition_Coparann_Entrance:	Title='Map/&Location_Coparann_Entrance_Title', Desc=''
MapWaypointDefinition_Coparann_Keep:	Title='Map/&Location_Coparann_Keep_Title', Desc=''
MapWaypointDefinition_Coparann_MineEntrance:	Title='Map/&Location_Coparann_MineEntrance_Title', Desc=''
MapWaypointDefinition_Coparann_Mines_ChariotEast:	Title='Map/&Waypoint_Coparran_Mines_ChariotEast', Desc=''
MapWaypointDefinition_Coparann_Mines_ChariotWest:	Title='Map/&Waypoint_Coparran_Mines_ChariotWest', Desc=''
MapWaypointDefinition_Coparann_Mines_DeadEnd:	Title='Map/&Waypoint_Coparran_Mines_DeadEnd', Desc=''
MapWaypointDefinition_Coparann_Mines_Entrance:	Title='Map/&Waypoint_Coparran_Mines_Entrance', Desc=''
MapWaypointDefinition_Coparann_Mines_Hideout:	Title='Map/&Waypoint_Coparran_Mines_Hideout', Desc=''
MapWaypointDefinition_Coparann_Mines_MinersCamp:	Title='Map/&Waypoint_Coparran_Mines_MinersCamp', Desc=''
MapWaypointDefinition_Coparann_Mines_NecroDoor:	Title='Map/&Waypoint_Coparran_Mines_NecroDoor', Desc=''
MapWaypointDefinition_Coparann_Mines_OldTomb:	Title='Map/&Waypoint_Coparran_Mines_Tomb', Desc=''
MapWaypointDefinition_Coparann_Mines_Switcher:	Title='Map/&Waypoint_Coparran_Mines_Switcher', Desc=''
MapWaypointDefinition_Coparann_Mines_TombPuzzle:	Title='Map/&Waypoint_Coparran_Mines_Puzzle', Desc=''
MapWaypointDefinition_Coparann_Prison:	Title='Map/&Location_Coparann_Prison_Title', Desc=''
MapWaypointDefinition_Coparann_Tavern:	Title='Map/&Location_Coparann_Tavern_Title', Desc=''
MapWaypointDefinition_Coparann_Teleporter:	Title='Map/&Location_Coparann_Teleporter_Title', Desc=''
MapWaypointDefinition_CradleOfFire_Bladefang:	Title='Map/&Location_CradleOfFire_Bladefang', Desc=''
MapWaypointDefinition_CradleOfFire_Bloodspear:	Title='Map/&Location_CradleOfFire_Bloodspear', Desc=''
MapWaypointDefinition_CradleOfFire_Burrows:	Title='Map/&Location_CradleOfFire_Burrows', Desc=''
MapWaypointDefinition_CradleOfFire_Crossroads:	Title='Map/&Location_CradleOfFire_Crossroads', Desc=''
MapWaypointDefinition_CradleOfFire_Entrance:	Title='Map/&Location_CradleOfFire_Entrance', Desc=''
MapWaypointDefinition_CradleOfFire_Market:	Title='Map/&Location_CradleOfFire_Market', Desc=''
MapWaypointDefinition_CradleOfFire_Necropolis:	Title='Map/&Location_CradleOfFire_Necropolis', Desc=''
MapWaypointDefinition_CradleOfFire_NecropolisHall:	Title='Map/&Location_CradleOfFire_NecropolisHall', Desc=''
MapWaypointDefinition_CradleOfFire_Outside:	Title='Map/&Location_CradleOfFire_Outside', Desc=''
MapWaypointDefinition_CradleOfFire_RedscarGate:	Title='Map/&Location_CradleOfFire_RedscarGate', Desc=''
MapWaypointDefinition_CradleOfFire_RedscarHall:	Title='Map/&Location_CradleOfFire_RedscarGateHall', Desc=''
MapWaypointDefinition_CradleOfFire_Sandraven:	Title='Map/&Location_CradleOfFire_SandRaven', Desc=''
MapWaypointDefinition_CradleOfFire_To_Crossroads:	Title='Map/&Location_CradleOfFire_To_Crossroads', Desc=''
MapWaypointDefinition_Default_Exit:	Title='Map/&Location_CaerLem_Exit_Title', Desc=''
MapWaypointDefinition_DLC1_BuriedCity_Crossroad:	Title='Map/&Waypoint_DLC1_BuriedCity_Crossroad', Desc=''
MapWaypointDefinition_DLC1_BuriedCity_DangerCorridor:	Title='Map/&Waypoint_DLC1_BuriedCity_DangerCorridor', Desc=''
MapWaypointDefinition_DLC1_BuriedCity_Entrance:	Title='Map/&Waypoint_DLC1_BuriedCity_Entrance', Desc=''
MapWaypointDefinition_DLC1_BuriedCity_MinorGate:	Title='Map/&Waypoint_DLC1_BuriedCity_MinorGate', Desc=''
MapWaypointDefinition_DLC1_BuriedCity_Palace_BuriedCityAccess:	Title='Map/&Waypoint_DLC1_BuriedCity_Palace_Door', Desc=''
MapWaypointDefinition_DLC1_BuriedCity_Palace_ForgeGate:	Title='Map/&Waypoint_DLC1_BuriedCity_Palace_Gate', Desc=''
MapWaypointDefinition_DLC1_BuriedCity_Palace_Lab:	Title='Map/&Waypoint_DLC1_BuriedCity_Palace_Lab', Desc=''
MapWaypointDefinition_DLC1_BuriedCity_Puzzle:	Title='Map/&Waypoint_DLC1_BuriedCity_Puzzle', Desc=''
MapWaypointDefinition_DLC1_BuriedCity_RebelEntrance:	Title='Map/&Waypoint_DLC1_City_SecretEntrance', Desc=''
MapWaypointDefinition_DLC1_BuriedCity_RebelHQ:	Title='Map/&Waypoint_DLC1_BuriedCity_RebelHQ', Desc=''
MapWaypointDefinition_DLC1_BuriedCity_RebelTown:	Title='Map/&Waypoint_DLC1_BuriedCity_Town', Desc=''
MapWaypointDefinition_DLC1_BuriedCity_Tomb:	Title='Map/&Waypoint_DLC1_Tomb', Desc=''
MapWaypointDefinition_DLC1_BuriedCity_WIndRoom:	Title='Map/&Waypoint_DLC1_BuriedCity_Windroom', Desc=''
MapWaypointDefinition_DLC1_City_Entrance:	Title='Map/&Waypoint_DLC1_City_Entrance', Desc=''
MapWaypointDefinition_DLC1_City_HighGate:	Title='Map/&Waypoint_DLC1_City_HighGate', Desc=''
MapWaypointDefinition_DLC1_City_Inn:	Title='Map/&Waypoint_DLC1_City_Inn', Desc=''
MapWaypointDefinition_DLC1_City_Lab:	Title='Map/&Waypoint_DLC1_City_Lab', Desc=''
MapWaypointDefinition_DLC1_City_Market:	Title='Map/&Waypoint_DLC1_City_ThePeople_Low', Desc=''
MapWaypointDefinition_DLC1_City_MaskHQ_High:	Title='Map/&Waypoint_DLC1_City_MaskOutpost', Desc=''
MapWaypointDefinition_DLC1_City_MaskHQ_Low:	Title='Map/&Waypoint_DLC1_City_MaskHQ_Low', Desc=''
MapWaypointDefinition_DLC1_City_MiddleGate:	Title='Map/&Waypoint_DLC1_City_MiddleGate', Desc=''
MapWaypointDefinition_DLC1_City_Palace:	Title='Map/&Waypoint_DLC1_City_Palace', Desc=''
MapWaypointDefinition_DLC1_City_PeoplesHideout:	Title='Map/&Waypoint_DLC1_City_PeopleHideout', Desc=''
MapWaypointDefinition_DLC1_City_PeoplesShelter:	Title='Map/&Waypoint_DLC1_City_PeoplesShelter', Desc=''
MapWaypointDefinition_DLC1_City_SecretEntrance:	Title='Map/&Waypoint_DLC1_City_SecretEntrance', Desc=''
MapWaypointDefinition_DLC1_City_ThroneRoom:	Title='Map/&Waypoint_DLC1_City_ThroneRoom', Desc=''
MapWaypointDefinition_DLC1_Complex_Captivity_Quarters:	Title='Map/&Waypoint_DLC1_Complex_Captivity_Quarters', Desc=''
MapWaypointDefinition_DLC1_Complex_DarkLab:	Title='Map/&Waypoint_DLC1_Complex_DarkLab', Desc=''
MapWaypointDefinition_DLC1_Complex_Elevator:	Title='Map/&Waypoint_DLC1_Complex_Elevator', Desc=''
MapWaypointDefinition_DLC1_Complex_Facilities:	Title='Map/&Waypoint_DLC1_Complex_Facilities', Desc=''
MapWaypointDefinition_DLC1_Complex_GroundFloor:	Title='Map/&Waypoint_DLC1_Complex_GroundFloor', Desc=''
MapWaypointDefinition_DLC1_Complex_GuardQuarters:	Title='Map/&Waypoint_DLC1_Complex_GuardQuarters', Desc=''
MapWaypointDefinition_DLC1_Complex_GuardRoom:	Title='Map/&Waypoint_DLC1_Complex_GuardRoom', Desc=''
MapWaypointDefinition_DLC1_Complex_Isolation_Unit:	Title='Map/&Waypoint_DLC1_Complex_Isolation_Unit', Desc=''
MapWaypointDefinition_DLC1_Complex_LivingRoom:	Title='Map/&Waypoint_DLC1_Complex_LivingRoom', Desc=''
MapWaypointDefinition_DLC1_Complex_MainEntrance:	Title='Map/&Waypoint_DLC1_Complex_MainEntrance', Desc=''
MapWaypointDefinition_DLC1_Complex_Major_Gate:	Title='Map/&Waypoint_DLC1_Complex_Minor_Gate', Desc=''
MapWaypointDefinition_DLC1_Complex_Mana_Generator:	Title='Map/&Waypoint_DLC1_Complex_Mana_Generator', Desc=''
MapWaypointDefinition_DLC1_Complex_OutdoorExit:	Title='Map/&Waypoint_DLC1_Complex_OutdoorExit', Desc=''
MapWaypointDefinition_DLC1_Complex_RearLobby:	Title='Map/&Waypoint_DLC1_Complex_RearLobby', Desc=''
MapWaypointDefinition_DLC1_Complex_SecondFloor:	Title='Map/&Waypoint_DLC1_Complex_SecondFloor', Desc=''
MapWaypointDefinition_DLC1_Complex_ServiceTunnels:	Title='Map/&Waypoint_DLC1_Complex_ServiceTunnels', Desc=''
MapWaypointDefinition_DLC1_Complex_ServiceTunnelsNorth:	Title='Map/&Waypoint_DLC1_Complex_ServiceTunnelsNorth', Desc=''
MapWaypointDefinition_DLC1_Complex_ServiceTunnelsSouth:	Title='Map/&Waypoint_DLC1_Complex_ServiceTunnelsSouth', Desc=''
MapWaypointDefinition_DLC1_Complex_StudyRoom:	Title='Map/&Waypoint_DLC1_Complex_StudyRoom', Desc=''
MapWaypointDefinition_DLC1_Complex_Test_Arena:	Title='Map/&Waypoint_DLC1_Complex_Test_Arena', Desc=''
MapWaypointDefinition_DLC1_Complex_TestLaboratory:	Title='Map/&Waypoint_DLC1_Complex_TestLaboratory', Desc=''
MapWaypointDefinition_DLC1_Complex_Trapdoor:	Title='Map/&Waypoint_DLC1_Complex_Trapdoor', Desc=''
MapWaypointDefinition_DLC1_Complex_Workshop:	Title='Map/&Waypoint_DLC1_Complex_Workshop', Desc=''
MapWaypointDefinition_DLC1_Marches_Camp:	Title='Map/&Waypoint_DLC1_Marches_Camp', Desc=''
MapWaypointDefinition_DLC1_Marches_GrottoEntrance:	Title='Map/&Waypoint_DLC1_Marches_GrottoEntrance', Desc=''
MapWaypointDefinition_DLC1_Marches_GrottoExit:	Title='Map/&Waypoint_DLC1_Marches_GrottoExit', Desc=''
MapWaypointDefinition_DLC1_Marches_MapExit:	Title='Map/&Waypoint_DLC1_Marches_MapExit', Desc=''
MapWaypointDefinition_DLC1_Marches_NestExit:	Title='Map/&Waypoint_DLC1_Marches_Nest', Desc=''
MapWaypointDefinition_DLC1_Marches_NestLastRoom:	Title='Map/&Waypoint_DLC1_Marches_NestExit', Desc=''
MapWaypointDefinition_DLC1_Marches_NestToGrotto:	Title='Map/&Waypoint_DLC1_Marches_RuinEntrance', Desc=''
MapWaypointDefinition_DLC1_Marches_VIP_Camp:	Title='Map/&Waypoint_DLC1_Marches_Vip_Camp', Desc=''
MapWaypointDefinition_DLC1_Swamp_Entrance:	Title='Map/&Waypoint_DLC1_Swamp_Entrance', Desc=''
MapWaypointDefinition_DLC1_Swamp_Exit_East:	Title='Map/&Waypoint_DLC1_Swamp_Exit_East', Desc=''
MapWaypointDefinition_DLC1_Swamp_Exit_South:	Title='Map/&Waypoint_DLC1_Swamp_Exit_South', Desc=''
MapWaypointDefinition_DLC1_Swamp_Exit_West:	Title='Map/&Waypoint_DLC1_Swamp_Exit_West', Desc=''
MapWaypointDefinition_DLC1_Swamp_Forge:	Title='Map/&Waypoint_DLC1_Swamp_Forge', Desc=''
MapWaypointDefinition_DLC1_Swamp_Fort:	Title='Map/&Waypoint_DLC1_Swamp_Fort', Desc=''
MapWaypointDefinition_DLC1_Swamp_GiantTree:	Title='Map/&Waypoint_DLC1_Swamp_GiantTree', Desc=''
MapWaypointDefinition_DLC1_Swamp_OldHut:	Title='Map/&Waypoint_DLC1_Swamp_OldHut', Desc=''
MapWaypointDefinition_DLC1_Swamp_River:	Title='Map/&Waypoint_DLC1_Swamp_River', Desc=''
MapWaypointDefinition_DLC1_Swamp_SpiderCave:	Title='Map/&Waypoint_DLC1_Swamp_SpiderCave', Desc=''
MapWaypointDefinition_DLC1_Swamp_Temple:	Title='Map/&Waypoint_DLC1_Swamp_Temple', Desc=''
MapWaypointDefinition_DLC1_Swamp_WitchHouse:	Title='Map/&Waypoint_DLC1_Swamp_WitchHouse', Desc=''
MapWaypointDefinition_DLC1_Valley_Adventurers_Camp:	Title='Map/&Waypoint_DLC1_Valley_Adventurers_Camp', Desc=''
MapWaypointDefinition_DLC1_Valley_Bears_Den:	Title='Map/&Waypoint_DLC1_Valley_Bears_Den', Desc=''
MapWaypointDefinition_DLC1_Valley_BrokenBridge:	Title='Map/&Waypoint_DLC1_Valley_BrokenBridge', Desc=''
MapWaypointDefinition_DLC1_Valley_Deserted_Refuge:	Title='Map/&Waypoint_DLC1_Valley_Deserted_Refuge', Desc=''
MapWaypointDefinition_DLC1_Valley_GiantCamp_Entrance:	Title='Map/&Waypoint_DLC1_Valley_GiantCamp_Entrance', Desc=''
MapWaypointDefinition_DLC1_Valley_GiantCamp_LongRest:	Title='Map/&Waypoint_DLC1_Valley_GiantCamp', Desc=''
MapWaypointDefinition_DLC1_Valley_Living_Quarters:	Title='Map/&Waypoint_DLC1_Valley_Living_Quarters', Desc=''
MapWaypointDefinition_DLC1_Valley_Lost_Temple:	Title='Map/&Waypoint_DLC1_Valley_Lost_Temple', Desc=''
MapWaypointDefinition_DLC1_Valley_Mausoleum:	Title='Map/&Waypoint_DLC1_Valley_Mausoleum', Desc=''
MapWaypointDefinition_DLC1_Valley_Mining_Vein:	Title='Map/&Waypoint_DLC1_Valley_Mining_Vein', Desc=''
MapWaypointDefinition_DLC1_Valley_Old_Jail:	Title='Map/&Waypoint_DLC1_Valley_Old_Jail', Desc=''
MapWaypointDefinition_DLC1_Valley_Outpost_LongRest:	Title='Map/&Waypoint_DLC1_Valley_Outpost', Desc=''
MapWaypointDefinition_DLC1_Valley_Plateau_Exit:	Title='Map/&Waypoint_DLC1_Valley_PlateauExit', Desc=''
MapWaypointDefinition_DLC1_Valley_PlateauHeights:	Title='Map/&Waypoint_DLC1_Valley_Plateau', Desc=''
MapWaypointDefinition_DLC1_Valley_RiverCamp_LongRest:	Title='Map/&Waypoint_DLC1_Valley_CampFire', Desc=''
MapWaypointDefinition_DLC1_Valley_Ruins:	Title='Map/&Waypoint_DLC1_Valley_Ruins', Desc=''
MapWaypointDefinition_DLC1_Valley_Ruins_Entrance:	Title='Map/&Waypoint_DLC1_Valley_Ruins_Entrance', Desc=''
MapWaypointDefinition_DLC1_Valley_The_Nest:	Title='Map/&Waypoint_DLC1_Valley_The_Nest', Desc=''
MapWaypointDefinition_DLC1_Valley_The_Walled_Camp:	Title='Map/&Waypoint_DLC1_Valley_The_Walled_Camp', Desc=''
MapWaypointDefinition_DLC1_Valley_Treasure_Room:	Title='Map/&Waypoint_DLC1_Valley_Treasure_Room', Desc=''
MapWaypointDefinition_DLC1_Valley_Warden_Quarters:	Title='Map/&Waypoint_DLC1_Valley_Warden_Quarters', Desc=''
MapWaypointDefinition_DLC1_Valley_Waterfall_Entrance:	Title='Map/&Waypoint_DLC1_Valley_Waterfall_Entrance', Desc=''
MapWaypointDefinition_DLC1_Valley_WaterfallGrotto:	Title='Map/&Waypoint_DLC1_Valley_Waterfall', Desc=''
MapWaypointDefinition_GENERIC_LONG_REST_AREA:	Title='Map/&Location_Generic_Long_Rest_Area_Title', Desc=''
MapWaypointDefinition_LavaForest_Clearing:	Title='Map/&Location_LavaForest_Clearing_Title', Desc=''
MapWaypointDefinition_LavaForest_Forest:	Title='Map/&Location_LavaForest_Forest_Title', Desc=''
MapWaypointDefinition_LavaForest_LavaRiver:	Title='Map/&Location_LavaForest_LavaRiver_Title', Desc=''
MapWaypointDefinition_Legendary_Camp:	Title='Map/&Location_Legendary_Camp_Title', Desc=''
MapWaypointDefinition_Legendary_CliffAccess:	Title='Map/&Location_Legendary_CliffAccess_Title', Desc=''
MapWaypointDefinition_Legendary_Temple:	Title='Map/&Location_Legendary_Temple_Title', Desc=''
MapWaypointDefinition_Location_HalmanSummersHouse01:	Title='Map/&Location_HalmanSummersHouse_Title', Desc=''
MapWaypointDefinition_Location_HalmanSummersHouse02:	Title='Map/&Location_HalmanSummersHouse2_Title', Desc=''
MapWaypointDefinition_Monastery_Cliff:	Title='Map/&Location_Monastery_Cliff_Title', Desc=''
MapWaypointDefinition_Monastery_LongRest:	Title='Map/&Location_Generic_Long_Rest_Area_Title', Desc=''
MapWaypointDefinition_Monastery_Mausoleum:	Title='Map/&Location_Monastery_Mausoleum_Title', Desc=''
MapWaypointDefinition_Monastery_Ruins:	Title='Map/&Location_BoneKeep_Cemetery_Title', Desc=''
MapWaypointDefinition_RodricHideout_Exit:	Title='Map/&Location_CaerLem_Exit_Title', Desc=''
MapWaypointDefinition_Telema_OrcCamp:	Title='Map/&Location_Telema_OrcCamp_Title', Desc=''
MapWaypointDefinition_Telema_Outdoor:	Title='Map/&Location_Telema_Outdoor_Title', Desc=''
MapWaypointDefinition_Telema_SpiderNest:	Title='Map/&Location_Telema_SpiderNest_Title', Desc=''
MapWaypointDefinition_TheID_TheArena:	Title='Map/&Location_TheID_TheArena_Title', Desc=''
MapWaypointDefinition_TheID_TheBeast:	Title='Map/&Location_TheID_TheBeast_Title', Desc=''
MapWaypointDefinition_TheID_TheGate:	Title='Map/&Location_TheID_TheGate_Title', Desc=''
MapWaypointDefinition_TheSuperEgo_TheBridge:	Title='Map/&Location_TheSuperEgo_TheBridge_Title', Desc=''
MapWaypointDefinition_TheSuperEgo_TheHall:	Title='Map/&Location_TheSuperEgo_TheHall_Title', Desc=''
MapWaypointDefinition_TheSuperEgo_TheLandingPad:	Title='Map/&Location_TheSuperEgo_TheLandingPad_Title', Desc=''
MapWaypointDefinition_TheSuperEgo_TheMastersRoom:	Title='Map/&Location_TheSuperEgo_TheMastersRoom_Title', Desc=''
MapWaypointDefinition_TirmarianTower_Exit:	Title='Map/&Location_CaerLem_Exit_Title', Desc=''
MapWaypointDefinition_TirmarianTower_Library:	Title='Map/&Location_CaerLem_LibraryTitle', Desc=''
MapWaypointDefinition_TOM_ScavengerCamp:	Title='Location/&UnknownCamp_Title', Desc=''
MapWaypointDefinition_TOM_Sector_01_A_Outdoor:	Title='Map/&Location_TowerOfMagic_Excavation_Title', Desc=''
MapWaypointDefinition_TOM_Sector_02_A_WeirdRoom:	Title='Map/&Location_TowerOfMagic_Library_Title', Desc=''
MapWaypointDefinition_TOM_Sector_03_A_CrownRoom:	Title='Map/&Location_TowerOfMagic_CrownRoom_Title', Desc=''
MapWaypointDefinition_WizardTower_Basement:	Title='Map/&Location_WizardTower_Basement_Title', Desc=''
MapWaypointDefinition_WizardTower_Camp:	Title='Map/&Location_WizardTower_Camp_Title', Desc=''
MapWaypointDefinition_WizardTower_Downhill:	Title='Map/&Location_WizardTower_Downhill_Title', Desc=''
MapWaypointDefinition_WizardTower_Hall:	Title='Map/&Location_WizardTower_Hall_Title', Desc=''
MapWaypointDefinition_WizardTower_LandingPad:	Title='Map/&Location_WizardTower_LandingPad_Title', Desc=''
MapWaypointDefinition_WizardTower_MainAlley:	Title='Map/&Location_WizardTower_MainAlley_Title', Desc=''
MapWaypointDefinition_WizardTower_MastersChamber:	Title='Map/&Location_WizardTower_MastersChamber_Title', Desc=''
MarketBooth_A:	Title='Prop/&MarketBoothTitle', Desc=''
MarketBooth_B:	Title='Prop/&MarketBoothTitle', Desc=''
MarketBooth_C:	Title='Prop/&MarketBoothTitle', Desc=''
MarketBooth_D:	Title='Prop/&MarketBoothTitle', Desc=''
MeleeAttack_Default:	Title='', Desc=''
Merchant_Banner:	Title='Prop/&Merchant_BannerTitle', Desc=''
Merchant_Sign:	Title='Prop/&Merchant_SignTitle', Desc=''
MerchantCamp:	Title='', Desc=''
Merton_0:	Title='', Desc=''
Merton_01_FirstScavenger:	Title='Campaign/&CrownOfTheMagister_Journal_Mertonsquest_01', Desc=''
Merton_02_AfterCouncil05:	Title='Campaign/&CrownOfTheMagister_Journal_DialogTitle_Merton_02_AfterCouncil05', Desc=''
Merton_03_MeetingBitterroot:	Title='Campaign/&CrownOfTheMagister_Journal_DialogTitle_Merton_03_MeetingBitterroot', Desc=''
Merton_04_BringingSword:	Title='Campaign/&CrownOfTheMagister_Journal_DialogTitle_Merton_04_BringingSword', Desc=''
Merton_05_LegendaryQuest01:	Title='Campaign/&CrownOfTheMagister_Journal_DialogTitle_Merton_05_LegendaryQuest01', Desc=''
Merton_05_LegendaryQuest02:	Title='Campaign/&CrownOfTheMagister_Journal_DialogTitle_Merton_05_LegendaryQuest02', Desc=''
Merton_05_LegendaryQuest03:	Title='Campaign/&CrownOfTheMagister_Journal_DialogTitle_Merton_05_LegendaryQuest03', Desc=''
Merton_05_LegendaryQuest04:	Title='Campaign/&CrownOfTheMagister_Journal_DialogTitle_Merton_05_LegendaryQuest04', Desc=''
Merton_05_LegendaryQuest05:	Title='Campaign/&CrownOfTheMagister_Journal_DialogTitle_Merton_05_LegendaryQuest05', Desc=''
Merton_05_LegendaryQuest06:	Title='Campaign/&CrownOfTheMagister_Journal_DialogTitle_Merton_05_LegendaryQuest06', Desc=''
Minotaur_Elite_Albinos_Presentation:	Title='', Desc=''
MinotaurCombatDecisions:	Title='', Desc=''
Mirror_A:	Title='Prop/&MirrorTitle', Desc=''
Mirror_B:	Title='Prop/&MirrorTitle', Desc=''
Mirror_B_Covered:	Title='Prop/&MirrorTitle', Desc=''
Mirror_C:	Title='Prop/&MirrorTitle', Desc=''
Monastery:	Title='', Desc=''
Monument_A:	Title='Prop/&MonumentTitle', Desc=''
Mossy:	Title='VisualMood/&MossyTitle', Desc=''
Move_Afraid:	Title='', Desc=''
Move_Aggressive:	Title='', Desc=''
Move_Aggressive_Remorhaz:	Title='', Desc=''
Move_AggressiveGrouped:	Title='', Desc=''
Move_AggressiveLightSensitive_Brood:	Title='', Desc=''
Move_AggressiveLightSensitive_Defiler:	Title='', Desc=''
Move_AggressiveLightSensitive_Legendary_Defiler:	Title='', Desc=''
Move_AggressiveLightSensitive_Legendary_Sorak:	Title='', Desc=''
Move_AggressiveLightSensitive_Spider_ForbidLight:	Title='', Desc=''
Move_AggressiveLightSensitive_Spider_PenalizeLight:	Title='', Desc=''
Move_AggressiveLightSensitiveAndSpread_Sorak:	Title='', Desc=''
Move_AggressiveLightSensitiveAssassin_Sorak:	Title='', Desc=''
Move_AggressiveSingleTarget:	Title='', Desc=''
Move_AggressiveSingleTarget_ForTeleporters:	Title='', Desc=''
Move_AggressiveSingleTarget_GreenHag:	Title='', Desc=''
Move_AggressiveSingleTarget_Invisible_GreenHag:	Title='', Desc=''
Move_AggressiveSingleTargetAndGrouped:	Title='', Desc=''
Move_AggressiveSingleTargetAndPack:	Title='', Desc=''
Move_AggressiveSingleTargetAndSpread:	Title='', Desc=''
Move_AggressiveSingleTargetAndSpread_OnlyIfMainActionAvailable:	Title='', Desc=''
Move_AggressiveWithAttackableAndRandom:	Title='', Desc=''
Move_Burrow_Aggressive_Large:	Title='', Desc=''
Move_Burrow_Aggressive_Small:	Title='', Desc=''
Move_Burrow_Bulette:	Title='', Desc=''
Move_Burrow_Bulette_Fallback:	Title='', Desc=''
Move_Caster_Multitarget:	Title='', Desc=''
Move_Dragon_AfterWingAttack:	Title='', Desc=''
Move_Dragon_Aggressive:	Title='', Desc=''
Move_Leap_Aggressive_Bulette:	Title='', Desc=''
Move_Leap_Bulette:	Title='', Desc=''
Move_PrepareCharge:	Title='', Desc=''
Move_PrepareCharge_Unsafe:	Title='', Desc=''
Move_PrepareDragonBreath_Unsafe:	Title='', Desc=''
Move_Ranged:	Title='', Desc=''
Move_RangedHalfScoreIfNotMobile:	Title='', Desc=''
Move_RangedKite:	Title='', Desc=''
Move_RangedLighSensitive_Sorak:	Title='', Desc=''
Move_RangedLightSensitive_FlyingSorak:	Title='', Desc=''
Move_RestlessLightSensitive:	Title='', Desc=''
Move_SoftDisengage:	Title='', Desc=''
Move_SoftDisengage_IfCondition:	Title='', Desc=''
Move_SoftDisengage_LightHypersensitive:	Title='', Desc=''
Move_SoftRetreat_Flying:	Title='', Desc=''
MovementAffinityJump:	Title='', Desc=''
Muddy:	Title='VisualMood/&MuddyTitle', Desc=''
MummyCombatDecision:	Title='', Desc=''
MummyLordCombatDecision:	Title='', Desc=''
Mushrooms_A:	Title='Prop/&MushroomsTitle', Desc=''
Mushrooms_B:	Title='Prop/&MushroomsTitle', Desc=''
MutantApeCombatDecisions:	Title='', Desc=''
Mystic:	Title='VisualMood/&MysticTitle', Desc=''
Narrative_Tree_Council_00:	Title='Campaign/&CrownOfTheMagister_Journal_DialogTitle_Council0', Desc=''
Narrative_Tree_Council_01_a:	Title='Campaign/&CrownOfTheMagister_Journal_DialogTitle_Council01_a', Desc=''
Narrative_Tree_Council_01_b:	Title='Campaign/&CrownOfTheMagister_Journal_DialogTitle_Council01_b', Desc=''
Narrative_Tree_Council_01_c:	Title='Campaign/&CrownOfTheMagister_Journal_DialogTitle_Council01_c', Desc=''
Narrative_Tree_Council_02_a:	Title='Campaign/&CrownOfTheMagister_Journal_DialogTitle_Council02_a', Desc=''
Narrative_Tree_Council_02_b:	Title='Campaign/&CrownOfTheMagister_Journal_DialogTitle_Council02_b', Desc=''
Narrative_Tree_Council_02_b_NEW:	Title='Campaign/&CrownOfTheMagister_Journal_DialogTitle_Council02_b', Desc=''
Narrative_Tree_Council_02_c:	Title='Campaign/&CrownOfTheMagister_Journal_DialogTitle_Council02_c', Desc=''
Narrative_Tree_Council_02_d:	Title='Campaign/&CrownOfTheMagister_Journal_DialogTitle_Council02_d', Desc=''
Narrative_Tree_Council_02_e:	Title='Campaign/&CrownOfTheMagister_Journal_DialogTitle_Council02_e', Desc=''
Narrative_Tree_Council_02_f:	Title='Campaign/&CrownOfTheMagister_Journal_DialogTitle_Council02_f', Desc=''
Narrative_Tree_Council_02_g:	Title='Campaign/&CrownOfTheMagister_Journal_DialogTitle_Council02_g', Desc=''
Narrative_Tree_Council_SAVE:	Title='Campaign/&CrownOfTheMagister_Journal_DialogTitle_Council0', Desc=''
Narrative_Tree_Intro_Aer_Elai:	Title='', Desc=''
NarrativeTree_CS_Carran_on_demand:	Title='Campaign/&CrownOfTheMagister_Journal_DialogTitle_AfterTuto4', Desc=''
Necromancer_CombatDecisions:	Title='', Desc=''
Necromancy_01:	Title='Campaign/&CrownOfTheMagister_Journal_Necromancy_01', Desc=''
Necromancy_02:	Title='Campaign/&CrownOfTheMagister_Journal_Necromancy_02', Desc=''
Necromancy_03:	Title='Campaign/&CrownOfTheMagister_Journal_Necromancy_03', Desc=''
Necromancy_04:	Title='Campaign/&CrownOfTheMagister_Journal_Necromancy_04', Desc=''
Necromancy_05:	Title='Campaign/&CrownOfTheMagister_Journal_Necromancy_05', Desc=''
Necromancy_06:	Title='Campaign/&CrownOfTheMagister_Journal_Necromancy_06', Desc=''
Necromancy_Bone_Keep_Solar_TP_M:	Title='', Desc=''
Necromancy_Generic_TP:	Title='Played when loading the level', Desc=''
Necromancy_Observable01:	Title='Campaign/&CrownOfTheMagister_Journal_Necromancy_Obs_01', Desc=''
Necromancy_Observable02:	Title='Campaign/&CrownOfTheMagister_Journal_DialogTitle_CaerLemGeneric', Desc=''
Necromancy_Observable03:	Title='Campaign/&CrownOfTheMagister_Journal_DialogTitle_CaerLemGeneric', Desc=''
Necromancy_Observable04:	Title='Campaign/&CrownOfTheMagister_Journal_DialogTitle_CaerLemGeneric', Desc=''
Necromancy_Observable05:	Title='Campaign/&CrownOfTheMagister_Journal_DialogTitle_CaerLemGeneric', Desc=''
Necromancy_Observable06:	Title='Campaign/&CrownOfTheMagister_Journal_DialogTitle_CaerLemGeneric', Desc=''
Necromancy_Observable07:	Title='Campaign/&CrownOfTheMagister_Journal_DialogTitle_CaerLemGeneric', Desc=''
Necromancy_Observable08:	Title='Campaign/&CrownOfTheMagister_Journal_DialogTitle_CaerLemGeneric', Desc=''
Necromancy_Observable09:	Title='Campaign/&CrownOfTheMagister_Journal_DialogTitle_CaerLemGeneric', Desc=''
Necromancy_Observable10:	Title='Campaign/&CrownOfTheMagister_Journal_DialogTitle_CaerLemGeneric', Desc=''
Necromancy_Observable11:	Title='Campaign/&CrownOfTheMagister_Journal_DialogTitle_CaerLemGeneric', Desc=''
Necromancy_Observable12:	Title='Campaign/&CrownOfTheMagister_Journal_DialogTitle_CaerLemGeneric', Desc=''
Necromancy_Observable13:	Title='Campaign/&CrownOfTheMagister_Journal_DialogTitle_CaerLemGeneric', Desc=''
Necromancy_Observable14:	Title='Campaign/&CrownOfTheMagister_Journal_DialogTitle_CaerLemGeneric', Desc=''
Necromancy_Observable15:	Title='Campaign/&CrownOfTheMagister_Journal_DialogTitle_CaerLemGeneric', Desc=''
Necromancy_Template:	Title='', Desc=''
NightStand_A:	Title='Prop/&NightStandTitle', Desc=''
NightStand_B:	Title='Prop/&NightStandTitle', Desc=''
NightStand_C:	Title='Prop/&NightStandTitle', Desc=''
None:	Title='', Desc=''
NPC_Presentation_Daliat_Sunbird:	Title='', Desc='Feature/&NoContentTitle'
NPC_Presentation_Dalon_Lark:	Title='', Desc='Feature/&NoContentTitle'
NPC_Presentation_Generic_Bandit_Dwarf_Female:	Title='', Desc='Feature/&NoContentTitle'
NPC_Presentation_Generic_Bandit_Dwarf_Male:	Title='', Desc='Feature/&NoContentTitle'
NPC_Presentation_Generic_Bandit_Elf_Female:	Title='', Desc='Feature/&NoContentTitle'
NPC_Presentation_Generic_Bandit_Elf_Male:	Title='', Desc='Feature/&NoContentTitle'
NPC_Presentation_Generic_Bandit_HalfElf_Female:	Title='', Desc='Feature/&NoContentTitle'
NPC_Presentation_Generic_Bandit_HalfElf_Male:	Title='', Desc='Feature/&NoContentTitle'
NPC_Presentation_Generic_Bandit_Halfling_Female:	Title='', Desc='Feature/&NoContentTitle'
NPC_Presentation_Generic_Bandit_Halfling_Male:	Title='', Desc='Feature/&NoContentTitle'
NPC_Presentation_Generic_Bandit_Human_Female:	Title='', Desc='Feature/&NoContentTitle'
NPC_Presentation_Generic_Bandit_Human_Male:	Title='', Desc='Feature/&NoContentTitle'
NPC_Presentation_Generic_BanditCaptain:	Title='', Desc='Feature/&NoContentTitle'
NPC_Presentation_Generic_Guard_Dwarf_Female:	Title='', Desc='Feature/&NoContentTitle'
NPC_Presentation_Generic_Guard_Dwarf_Male:	Title='', Desc='Feature/&NoContentTitle'
NPC_Presentation_Generic_Guard_Elf_Female:	Title='', Desc='Feature/&NoContentTitle'
NPC_Presentation_Generic_Guard_Elf_Male:	Title='', Desc='Feature/&NoContentTitle'
NPC_Presentation_Generic_Guard_HalfElf_Female:	Title='', Desc='Feature/&NoContentTitle'
NPC_Presentation_Generic_Guard_HalfElf_Male:	Title='', Desc='Feature/&NoContentTitle'
NPC_Presentation_Generic_Guard_Halfling_Female:	Title='', Desc=''
NPC_Presentation_Generic_Guard_Halfling_Male:	Title='', Desc=''
NPC_Presentation_Generic_Guard_Human_Female:	Title='', Desc=''
NPC_Presentation_Generic_Guard_Human_Male:	Title='', Desc=''
NPC_Presentation_Generic_Highwayman_AF_Female:	Title='', Desc='Feature/&NoContentTitle'
NPC_Presentation_Generic_Highwayman_AF_Male:	Title='', Desc='Feature/&NoContentTitle'
NPC_Presentation_Generic_Highwayman_AS_Female:	Title='', Desc='Feature/&NoContentTitle'
NPC_Presentation_Generic_Highwayman_AS_Male:	Title='', Desc='Feature/&NoContentTitle'
NPC_Presentation_Generic_Highwayman_CA_Female:	Title='', Desc='Feature/&NoContentTitle'
NPC_Presentation_Generic_Highwayman_CA_Male:	Title='', Desc='Feature/&NoContentTitle'
NPC_Presentation_Gromnir_Stonefist:	Title='', Desc='Feature/&NoContentTitle'
NPC_Presentation_Joris_Nikannen:	Title='', Desc='Feature/&NoContentTitle'
NPC_Presentation_Karel_Martel:	Title='', Desc='Feature/&NoContentTitle'
NPC_Presentation_Kythaela:	Title='', Desc='Feature/&NoContentTitle'
NPC_Presentation_Lisbath_Townsend:	Title='', Desc='Feature/&NoContentTitle'
NPC_Presentation_Tutorial_Prison_Bandit:	Title='', Desc='Feature/&NoContentTitle'
NPC_Presentation_Tutorial_Prison_Bandit2:	Title='', Desc='Feature/&NoContentTitle'
NPC_Presentation_Tutorial_Prison_Bandit3:	Title='', Desc='Feature/&NoContentTitle'
NPC_Presentation_Tutorial_Stealth_Bandit_Dwarf:	Title='', Desc='Feature/&NoContentTitle'
NPC_Presentation_Tutorial_Stealth_Bandit_Dwarf_Female:	Title='', Desc='Feature/&NoContentTitle'
NPC_Presentation_Tutorial_Stealth_Bandit_Elf_Female:	Title='', Desc='Feature/&NoContentTitle'
NPC_Presentation_Tutorial_Stealth_Liam:	Title='', Desc='Feature/&NoContentTitle'
NPC_Presentation_Tutorial_Stealth_Loan_Shark:	Title='', Desc='Feature/&NoContentTitle'
NPC_Test:	Title='', Desc='Feature/&NoContentTitle'
Ocher:	Title='VisualMood/&OcherTitle', Desc=''
OffensiveCasterCombatDecisions:	Title='', Desc=''
OldMine_Debris_A:	Title='Prop/&DebrisATitle', Desc=''
OldMine_Structure_A:	Title='Prop/&StructureTitle', Desc=''
OldMine_Structure_B:	Title='Prop/&StructureTitle', Desc=''
OldMine_Structure_C:	Title='Prop/&StructureTitle', Desc=''
OldMine_Structure_D:	Title='Prop/&StructureTitle', Desc=''
OldMine_Structure_E:	Title='Prop/&StructureTitle', Desc=''
Oracle:	Title='', Desc=''
Orc_Female_Archer_BladeFang:	Title='', Desc=''
Orc_Female_Archer_BloodSpear:	Title='', Desc=''
Orc_Female_Archer_RedScar:	Title='', Desc=''
Orc_Female_Archer_SandRaven:	Title='', Desc=''
Orc_Female_Archer_SunCloud:	Title='', Desc=''
Orc_Female_Chieftain_Redscar:	Title='', Desc=''
Orc_Female_Chieftain_SunCloud_Kebra:	Title='', Desc=''
Orc_Female_Grunt_BladeFang:	Title='', Desc=''
Orc_Female_Grunt_BloodSpear:	Title='', Desc=''
Orc_Female_Grunt_RedScar:	Title='', Desc=''
Orc_Female_Grunt_SandRaven:	Title='', Desc=''
Orc_Female_Grunt_SunCloud:	Title='', Desc=''
Orc_Male_Archer_BladeFang:	Title='', Desc=''
Orc_Male_Archer_BloodSpear:	Title='', Desc=''
Orc_Male_Archer_RedScar:	Title='', Desc=''
Orc_Male_Archer_SandRaven:	Title='', Desc=''
Orc_Male_Archer_SunCloud:	Title='', Desc=''
Orc_Male_Chieftain_BladeFang:	Title='', Desc=''
Orc_Male_Chieftain_BloodSpear:	Title='', Desc=''
Orc_Male_Chieftain_RedScar:	Title='', Desc=''
Orc_Male_Chieftain_SandRaven:	Title='', Desc=''
Orc_Male_Chieftain_SunCloud:	Title='', Desc=''
Orc_Male_Grunt_BladeFang:	Title='', Desc=''
Orc_Male_Grunt_BloodSpear:	Title='', Desc=''
Orc_Male_Grunt_RedScar:	Title='', Desc=''
Orc_Male_Grunt_SandRaven:	Title='', Desc=''
Orc_Male_Grunt_SunCloud:	Title='', Desc=''
Orc_Male_Rogrok:	Title='', Desc=''
OrcArcherCombatDecisions:	Title='', Desc=''
OrcCombatDecisions:	Title='', Desc=''
OrcGrimbladeCombatDecisions:	Title='', Desc=''
OrcstrongHold_Intro:	Title='', Desc=''
Outpost:	Title='', Desc=''
Paint_A:	Title='Prop/&PaintingTitle', Desc=''
Paint_A_Covered:	Title='Prop/&PaintingTitle', Desc=''
Paint_B:	Title='Prop/&PaintingTitle', Desc=''
Paint_B_Covered:	Title='Prop/&PaintingTitle', Desc=''
Paint_C:	Title='Prop/&PaintingTitle', Desc=''
Paint_C_Covered:	Title='Prop/&PaintingTitle', Desc=''
PaladinCombatDecisions:	Title='', Desc=''
Past:	Title='VisualMood/&PastTitle', Desc=''
Path_Crossroad:	Title='Prop/&Path_CrossRoadTitle', Desc=''
Path_End:	Title='Prop/&Path_EndTitle', Desc=''
Path_Sjunction_A:	Title='Prop/&Path_SjunctionTitle', Desc=''
Path_Sjunction_B:	Title='Prop/&Path_SjunctionTitle', Desc=''
Path_Straight_A:	Title='Prop/&Path_StraightTitle', Desc=''
Path_Straight_B:	Title='Prop/&Path_StraightTitle', Desc=''
Path_Straight_C:	Title='Prop/&Path_StraightTitle', Desc=''
Path_Straight_D:	Title='Prop/&Path_StraightTitle', Desc=''
Path_Turn:	Title='Prop/&Path_TurnTitle', Desc=''
Path_Yjunction:	Title='Prop/&Path_YjunctionTitle', Desc=''
Patrol_Default_No_Attack:	Title='', Desc=''
Patrol_DefaultDecisions:	Title='', Desc=''
Patrol_MoveToNextNode:	Title='', Desc=''
Patrol_TutorialDecisions:	Title='', Desc=''
Patrol_WaitDurationOnly:	Title='', Desc=''
Patrol_WaitDurationOnly_1:	Title='', Desc=''
Patrol_WaitDurationOnly_10:	Title='', Desc=''
Patrol_WaitDurationOnly_30:	Title='', Desc=''
Patrol_WaitDurationOnly_45:	Title='', Desc=''
Patrol_WaitDurationOnly_60:	Title='', Desc=''
Patrol_WaitForGroupThenDuration:	Title='', Desc=''
Patrol_WaitForGroupThenDuration_30:	Title='', Desc=''
Patrol_WaitForGroupThenDuration_5:	Title='', Desc=''
PatrolNode_GroupAndTimeWait:	Title='', Desc=''
PatrolNode_GroupAndTimeWait_30:	Title='', Desc=''
PatrolNode_GroupAndTimeWait_5:	Title='', Desc=''
PatrolNode_HuskTimeWait:	Title='', Desc=''
PatrolNode_TimeWait:	Title='', Desc=''
PatrolNode_TimeWait_1:	Title='', Desc=''
PatrolNode_TimeWait_10:	Title='', Desc=''
PatrolNode_TimeWait_30:	Title='', Desc=''
Paved_Road_DeadEnd:	Title='Prop/&Paved_Road_DeadEndTitle', Desc=''
Paved_Road_RoundCenter_A:	Title='Prop/&Paved_Road_SquareTitle', Desc=''
Paved_Road_RoundCenter_B:	Title='Prop/&Paved_Road_SquareTitle', Desc=''
Paved_Road_RoundTurn:	Title='Prop/&Paved_Road_TurnTitle', Desc=''
Paved_Road_SquareCenter_A:	Title='Prop/&Paved_Road_SquareTitle', Desc=''
Paved_Road_SquareCenter_B:	Title='Prop/&Paved_Road_SquareTitle', Desc=''
Paved_Road_SquareCenter_C:	Title='Prop/&Paved_Road_SquareTitle', Desc=''
Paved_Road_Straight_1C:	Title='Prop/&Paved_Road_StraightTitle', Desc=''
Paved_Road_Straight_2C:	Title='Prop/&Paved_Road_StraightTitle', Desc=''
Paved_Road_Straight_3C:	Title='Prop/&Paved_Road_StraightTitle', Desc=''
Paved_Road_Straight_4C:	Title='Prop/&Paved_Road_StraightTitle', Desc=''
Paved_Road_TShape:	Title='Prop/&Paved_Road_TShapeTitle', Desc=''
Paved_Road_XCrossRoads:	Title='Prop/&Paved_Road_CrossTitle', Desc=''
Pennant_A:	Title='Prop/&PennantTitle', Desc=''
Pennant_B:	Title='Prop/&PennantTitle', Desc=''
PhaseSpiderCombatDecisions:	Title='', Desc=''
PickupQuest_AncientKnowledge:	Title='Quest/&PickupQuest_03_AncientKnowledge_Title', Desc=''
PickupQuest_AncientKnowledge_Scenario:	Title='', Desc=''
PickupQuest_BitterrootTreasure_Scenario:	Title='', Desc=''
PickupQuest_Collector_Scenario:	Title='', Desc=''
PickupQuest_GhostsOfTheEmpire_Scenario:	Title='', Desc=''
PickupQuest_GoblinCulture_Scenario:	Title='', Desc=''
PickupQuest_HickoryCorner_Scenario:	Title='', Desc=''
PickupQuest_HiddenBlade_Scenario:	Title='FindTheHiddenBlade', Desc=''
PickupQuest_LavaForest_Scenario:	Title='', Desc=''
PickupQuest_MagisterAmulet:	Title='Quest/&PickupQuest_08_MagisterAmulet_Title', Desc=''
PickupQuest_ResearchCrown_Scenario:	Title='', Desc=''
PickupQuest_RunsInTheFamily_Scenario:	Title='', Desc=''
PitchBlack:	Title='VisualMood/&PichBlackTitle', Desc=''
Planks_A:	Title='Prop/&PlanksTitle', Desc=''
Planks_B:	Title='Prop/&PlanksTitle', Desc=''
Planks_C:	Title='Prop/&PlanksTitle', Desc=''
Plant_A:	Title='Prop/&PlantTitle', Desc=''
Plant_B:	Title='Prop/&PlantTitle', Desc=''
PoisonBulb:	Title='Gadget/&PoisonBulbTitle', Desc=''
Pond_Large_24C:	Title='Room/&Pond_Large_24CTitle', Desc=''
Pond_Small_12C:	Title='Room/&Pond_Small_12CTitle', Desc=''
PostAbjurationCompatibilityScenario_EA_0.5:	Title='Retrocompatibility fixes force campaign scenario state post Abjuration', Desc=''
Priest_Arun:	Title='Campaign/&CrownOfTheMagister_Journal_DialogTitle_PriestOfArun', Desc=''
Priest_Maraike:	Title='Campaign/&CrownOfTheMagister_Journal_DialogTitle_PriestOfMaraike', Desc=''
Priest_Pakri:	Title='Campaign/&CrownOfTheMagister_Journal_DialogTitle_PriestOfPakri', Desc=''
Prison:	Title='', Desc=''
PrisonFence_Link:	Title='Prop/&PrisonFenceTitle', Desc=''
PrisonFence_Link_LowGround:	Title='Prop/&PrisonFenceTitle', Desc=''
PrisonFence_Straight_A:	Title='Prop/&PrisonFenceTitle', Desc=''
PrisonFence_Straight_LowGround_A:	Title='Prop/&PrisonFenceTitle', Desc=''
Purplish:	Title='VisualMood/&PurplishTitle', Desc=''
Quest_Background_Academic:	Title='Quest/&Quest_Background_Academic_Title', Desc=''
Quest_Background_Academic_Scenario:	Title='AcademicQuest', Desc=''
Quest_Background_Acolyte:	Title='Quest/&Subquest_Acolyte_Quest_Title', Desc=''
Quest_Background_Acolyte_Recall:	Title='Quest/&Subquest_Acolyte_Quest_Title', Desc=''
Quest_Background_Acolyte_Scenario:	Title='Quest/&Subquest_Acolyte_Quest_Title', Desc=''
Quest_Background_Aristocrat:	Title='Quest/&Quest_Background_Aristocrat_Title', Desc=''
Quest_Background_Aristocrat_Scenario:	Title='AristocratQuest', Desc=''
Quest_Background_Lawkeeper:	Title='Quest/&Quest_Background_Lawkeeper_Title', Desc=''
Quest_Background_Lawkeeper_Scenario:	Title='', Desc=''
Quest_Background_Lowlife:	Title='Quest/&Quest_Background_Lowlife_Title', Desc=''
Quest_Background_Lowlife_Scenario:	Title='Quest/&Quest_Background_Lowlife_Title', Desc=''
Quest_Background_Philosopher:	Title='Quest/&Quest_Background_Philosopher_Title', Desc=''
Quest_Background_Philosopher_Scenario:	Title='', Desc=''
Quest_Background_Sellsword:	Title='Quest/&Quest_Background_Sellsword_Title', Desc=''
Quest_Background_Sellsword_Scenario:	Title='', Desc=''
Quest_Background_Spy:	Title='Quest/&Quest_Background_Spy_Title', Desc=''
Quest_Background_Spy_Scenario:	Title='', Desc=''
Quest_Background_Wanderer_Quest:	Title='Quest/&Wanderer_BGQuest_MainTitle', Desc=''
Quest_Background_Wanderer_Scenario:	Title='WandererBGquestScenario', Desc=''
Radiant:	Title='VisualMood/&RadiantTitle', Desc=''
RangedAttack_Default:	Title='', Desc=''
RangedAttack_WithRandom:	Title='', Desc=''
RangedWithSelfHealCombatDecisions:	Title='', Desc=''
ReadingDesk_A:	Title='Prop/&ReadingDeskTitle', Desc=''
ReadingDesk_B:	Title='Prop/&ReadingDeskTitle', Desc=''
Redeemer_Presentation_Basic:	Title='', Desc=''
Redeemer_Presentation_Gold:	Title='', Desc=''
Redeemer_Presentation_Juggernaut:	Title='', Desc=''
Redeemer_Presentation_Red:	Title='', Desc=''
RedeemerCombatDecisions:	Title='', Desc=''
RemorhazCombatDecisions:	Title='', Desc=''
RitualStone_A:	Title='Prop/&RitualStoneTitle', Desc=''
RitualStone_B:	Title='Prop/&RitualStoneTitle', Desc=''
River_A_Large_24C:	Title='Room/&River_24CTitle', Desc=''
River_B_Large_24C:	Title='Room/&River_24CTitle', Desc=''
River_C_Large_24C:	Title='Room/&River_24CTitle', Desc=''
River_D_Large_24C:	Title='Room/&River_24CTitle', Desc=''
Road_Line_B_6C:	Title='Room/&Stonghold_Connection_24CTitle', Desc=''
Rock_A:	Title='Prop/&RockTitle', Desc=''
Rock_B:	Title='Prop/&RockTitle', Desc=''
Rock_C:	Title='Prop/&RockTitle', Desc=''
Rock_D:	Title='Prop/&RockTitle', Desc=''
Rock_E:	Title='Prop/&RockTitle', Desc=''
Rock_F:	Title='Prop/&RockTitle', Desc=''
Rock_G:	Title='Prop/&RockTitle', Desc=''
RodricHideoutEntranceCompatibilityScenario:	Title='', Desc=''
RogueCombatDecisions:	Title='', Desc=''
Room_A_12C:	Title='Room/&Room_12CTitle', Desc=''
Room_B_12C:	Title='Room/&Room_12CTitle', Desc=''
Room_Big_24C:	Title='Room/&Room_Big_24CTitle', Desc=''
Room_Big_24C_A_Organic:	Title='Room/&Room_Big_24CTitle', Desc=''
Room_Big_24C_B_Organic:	Title='Room/&Room_Big_24CTitle', Desc=''
Room_Big_24C_C_Organic:	Title='Room/&Room_Big_24CTitle', Desc=''
Room_Big_48C_Organic:	Title='Room/&Room_Big_48CTitle', Desc=''
Room_Big_HighGround_A_24C:	Title='Room/&Big_HighGround_24CTitle', Desc=''
Room_Big_HighGround_B_24C:	Title='Room/&Big_HighGround_24CTitle', Desc=''
Room_Big_Necropolis_24C:	Title='Room/&Room_Big_24CTitle', Desc=''
Room_Half_48C_Organic:	Title='Room/&Room_Big_48CTitle', Desc=''
Room_High_12C:	Title='Room/&Room_High_12CTitle', Desc=''
Room_High_Line_12C:	Title='Room/&Room_High_12CTitle', Desc=''
Room_Small_24C:	Title='Room/&Room_Small_24CTitle', Desc=''
Room_Small_24C_A_Organic:	Title='Room/&Room_Small_24CTitle', Desc=''
Room_Small_24C_B_Organic:	Title='Room/&Room_Small_24CTitle', Desc=''
Room_Small_High_24C:	Title='Room/&Room_High_12CTitle', Desc=''
Root_A:	Title='Prop/&RootTitle', Desc=''
Root_B:	Title='Prop/&RootTitle', Desc=''
Root_C:	Title='Prop/&RootTitle', Desc=''
Ruin_Large_24C:	Title='Room/&Ruin_Large_24CTitle', Desc=''
Ruin_Small_12C:	Title='Room/&Ruin_Small_12CTitle', Desc=''
RuinedArch_A:	Title='Prop/&ArchTitle', Desc=''
RuinedArch_B:	Title='Prop/&ArchTitle', Desc=''
RuinedArchEnd_A:	Title='Prop/&ArchEndTitle', Desc=''
RuinedArchEnd_B:	Title='Prop/&ArchEndTitle', Desc=''
RuinedKiosk_A:	Title='Prop/&RuinedKioskTitle', Desc=''
RuinedKiosk_B:	Title='Prop/&RuinedKioskTitle', Desc=''
RuinedWall_A:	Title='Prop/&RuinedWallTitle', Desc=''
RuinedWall_B:	Title='Prop/&RuinedWallTitle', Desc=''
RuinedWall_C:	Title='Prop/&RuinedWallTitle', Desc=''
RuinedWall_D:	Title='Prop/&RuinedWallTitle', Desc=''
RuinedWall_E:	Title='Prop/&RuinedWallTitle', Desc=''
RuinedWall_F:	Title='Prop/&RuinedWallTitle', Desc=''
Scaffolding_A:	Title='Prop/&ScaffoldingTitle', Desc=''
Scaffolding_B:	Title='Prop/&ScaffoldingTitle', Desc=''
Scaffolding_C:	Title='Prop/&ScaffoldingTitle', Desc=''
ScavengerCompatibilityScenario_EA_0.4.0:	Title='Retrocompatibility fixes for scavengers 0.3.0 => 0.4.0', Desc=''
Secondary_KillRazan_Quest:	Title='Quest/&KillRazan_Title', Desc=''
Secondary_KillRazan_Scenario:	Title='', Desc=''
ShamblingMoundCombatDecisions:	Title='', Desc=''
Shelves_A:	Title='Prop/&ShelvesTitle', Desc=''
Shelves_B:	Title='Prop/&ShelvesTitle', Desc=''
Shelves_C:	Title='Prop/&ShelvesTitle', Desc=''
Shelves_D:	Title='Prop/&ShelvesTitle', Desc=''
Shelves_E:	Title='Prop/&ShelvesTitle', Desc=''
Shelves_TownInt_A:	Title='Prop/&ShelvesTitle', Desc=''
Shelves_TownInt_B:	Title='Prop/&ShelvesTitle', Desc=''
Shelves_TownInt_C:	Title='Prop/&ShelvesTitle', Desc=''
Shelves_TownInt_D:	Title='Prop/&ShelvesTitle', Desc=''
Shop_Big_Structure_A:	Title='Prop/&ShopStructureTitle', Desc=''
Shop_Big_Structure_B:	Title='Prop/&ShopStructureTitle', Desc=''
Shop_Big_Structure_C:	Title='Prop/&ShopStructureTitle', Desc=''
Shop_Big_Structure_D:	Title='Prop/&ShopStructureTitle', Desc=''
Shop_Book_Stand_A:	Title='Prop/&ShopBookStandTitle', Desc=''
Shop_Book_Stand_B:	Title='Prop/&ShopBookStandTitle', Desc=''
Shop_Book_Stand_C:	Title='Prop/&ShopBookStandTitle', Desc=''
Shop_Food_Stand_A:	Title='Prop/&ShopFoodStandTitle', Desc=''
Shop_Food_Stand_B:	Title='Prop/&ShopFoodStandTitle', Desc=''
Shop_Food_Stand_C:	Title='Prop/&ShopFoodStandTitle', Desc=''
Shop_Food_Stand_D:	Title='Prop/&ShopFoodStandTitle', Desc=''
Shop_Food_Stand_E:	Title='Prop/&ShopFoodStandTitle', Desc=''
Shop_General Store:	Title='Prop/&ShopGeneralStoreTitle', Desc=''
Shop_Generic_NoShed_A:	Title='Prop/&GenericShopTitle', Desc=''
Shop_Generic_NoShed_B:	Title='Prop/&GenericShopTitle', Desc=''
Shop_Generic_NoShed_C:	Title='Prop/&GenericShopTitle', Desc=''
Shop_Generic_NoShed_D:	Title='Prop/&GenericShopTitle', Desc=''
Shop_Generic_Shed_A:	Title='Prop/&GenericShopTitle', Desc=''
Shop_Generic_Shed_B:	Title='Prop/&GenericShopTitle', Desc=''
Shop_Generic_Shed_C:	Title='Prop/&GenericShopTitle', Desc=''
Shop_Generic_Shed_D:	Title='Prop/&GenericShopTitle', Desc=''
Shop_Magic:	Title='Prop/&ShopMagicTitle', Desc=''
Shop_Stage_A:	Title='Prop/&StairsTitle', Desc=''
Shop_Stage_B:	Title='Prop/&StairsTitle', Desc=''
Shop_WoodenShed_A:	Title='Prop/&Shop_WoodenShedTitle', Desc=''
Shop_WoodenShed_B:	Title='Prop/&Shop_WoodenShedTitle', Desc=''
ShopBook_Counter_A:	Title='Prop/&ShopBookCounterTitle', Desc=''
ShopBook_Counter_B:	Title='Prop/&ShopBookCounterTitle', Desc=''
ShopBook_Counter_C:	Title='Prop/&ShopBookCounterTitle', Desc=''
ShopFood_Counter_A:	Title='Prop/&ShopFoodCounterTitle', Desc=''
ShopFood_Counter_B:	Title='Prop/&ShopFoodCounterTitle', Desc=''
ShopFood_Counter_C:	Title='Prop/&ShopFoodCounterTitle', Desc=''
ShopGeneral_Counter_A:	Title='Prop/&ShopGeneralCounterTitle', Desc=''
ShopGeneral_Counter_B:	Title='Prop/&ShopGeneralCounterTitle', Desc=''
ShopGeneral_Counter_C:	Title='Prop/&ShopGeneralCounterTitle', Desc=''
ShoveBack_Default:	Title='', Desc=''
ShoveDown_Default:	Title='', Desc=''
ShoveDown_Frequent:	Title='', Desc=''
ShoveDown_Weak:	Title='', Desc=''
Silver_Dragon_Presentation:	Title='', Desc=''
SkeletonKnightCombatDecisions:	Title='', Desc=''
SkeletonSorcererCombatDecisions:	Title='', Desc=''
Skins_A:	Title='Prop/&SkinsTitle', Desc=''
Skins_B:	Title='Prop/&SkinsTitle', Desc=''
Skins_C:	Title='Prop/&SkinsTitle', Desc=''
SkullPile_A:	Title='Prop/&SkullPileTitle', Desc=''
SkullPile_B:	Title='Prop/&SkullPileTitle', Desc=''
SkullPile_C:	Title='Prop/&SkullPileTitle', Desc=''
Slope_A:	Title='Prop/&SlopeTitle', Desc=''
Small_Beetle_Presentation_Basic:	Title='', Desc=''
SmallWalls_A:	Title='Prop/&TownSeparationWallsTitle', Desc=''
SmallWalls_B:	Title='Prop/&TownSeparationWallsTitle', Desc=''
SmallWalls_Butress_A:	Title='Prop/&TownSeparationButressTitle', Desc=''
SmallWalls_Butress_B:	Title='Prop/&TownSeparationButressTitle', Desc=''
SmallWalls_C:	Title='Prop/&TownSeparationWallsTitle', Desc=''
SmallWalls_D:	Title='Prop/&TownSeparationWallsTitle', Desc=''
SmallWalls_E:	Title='Prop/&TownSeparationWallsTitle', Desc=''
SmallWalls_F:	Title='Prop/&TownSeparationWallsTitle', Desc=''
SmallWalls_G:	Title='Prop/&TownSeparationWallsTitle', Desc=''
SmallWalls_H:	Title='Prop/&TownSeparationWallsTitle', Desc=''
SorakAcolyteCombatDecisions:	Title='', Desc=''
SorakAssassinCombatDecisions:	Title='', Desc=''
SorakGruntCombatDecisions:	Title='', Desc=''
SorakSaboteurCombatDecisions:	Title='', Desc=''
SorakShikkathAndBossCombatDecisions:	Title='', Desc=''
SorakSkirmisherCombatDecisions:	Title='', Desc=''
SoundbanksDefinition:	Title='', Desc=''
SpiderCombatDecisions:	Title='', Desc=''
SpiderEggs_A:	Title='Prop/&SpiderEggsTitle', Desc=''
SpiderEggs_B:	Title='Prop/&SpiderEggsTitle', Desc=''
SpiderEggs_C:	Title='Prop/&SpiderEggsTitle', Desc=''
SpiderEggs_D:	Title='Prop/&SpiderEggsTitle', Desc=''
SpiderNest:	Title='', Desc=''
SpiderQueenCombatDecisions:	Title='', Desc=''
SpiderWebs_A:	Title='Prop/&SpiderWebsTitle', Desc=''
SpiderWebs_B:	Title='Prop/&SpiderWebsTitle', Desc=''
SpiderWebs_C:	Title='Prop/&SpiderWebsTitle', Desc=''
SpiderWebs_D:	Title='Prop/&SpiderWebsTitle', Desc=''
SpinningWheel:	Title='Prop/&SpinningWheelTitle', Desc=''
Spooky:	Title='VisualMood/&SpookyTitle', Desc=''
Spyfort:	Title='', Desc=''
SpyPlantDocumentCompatibilityScenario:	Title='', Desc=''
Stable_A:	Title='Prop/&StableTitle', Desc=''
Stable_B:	Title='Prop/&StableTitle', Desc=''
Stable_C:	Title='Prop/&StableTitle', Desc=''
Stairs_A:	Title='Prop/&StairsTitle', Desc=''
Stairs_B:	Title='Prop/&StairsTitle', Desc=''
Stairs_Destroyed_A:	Title='Prop/&StairsDestoyedTitle', Desc=''
Stairs_Destroyed_B:	Title='Prop/&StairsDestoyedTitle', Desc=''
StairsTavern:	Title='Prop/&StairsTitle', Desc=''
Stalagmite_A:	Title='Prop/&StalagmiteTitle', Desc=''
Stalagmite_B:	Title='Prop/&StalagmiteTitle', Desc=''
Stalagmite_C:	Title='Prop/&StalagmiteTitle', Desc=''
Stalagmite_D:	Title='Prop/&StalagmiteTitle', Desc=''
StandUp:	Title='', Desc=''
StandUpIfProne:	Title='', Desc=''
Start_Automated_Test_Cutscene:	Title='', Desc=''
StartBattle:	Title='', Desc=''
StartBattle_CanTargetNPC:	Title='', Desc=''
StaticDragonCombatDecisions:	Title='', Desc=''
Statue_A:	Title='Prop/&StatueTitle', Desc=''
Statue_B:	Title='Prop/&StatueTitle', Desc=''
Statue_C:	Title='Prop/&StatueTitle', Desc=''
Statue_D:	Title='Prop/&StatueTitle', Desc=''
Statue_E_Covered:	Title='Prop/&StatueTitle', Desc=''
Statue_Little_Emperor:	Title='Prop/&Statue_Little_EmperorTitle', Desc=''
Statue_Maisy_Jade:	Title='Prop/&Statue_Maisy_JadeTitle', Desc=''
Statue_Maisy_Marble:	Title='Prop/&Statue_Maisy_MarbleTitle', Desc=''
Statue_Maisy_Stone:	Title='Prop/&Statue_Maisy_StoneTitle', Desc=''
Statue_Misaye:	Title='Prop/&Statue_MisayeTitle', Desc=''
Stench:	Title='VisualMood/&StenchTitle', Desc=''
Still_A:	Title='Prop/&StillTitle', Desc=''
Still_Covered_A:	Title='Prop/&StillTitle', Desc=''
Stone_A:	Title='Prop/&RockTitle', Desc=''
Stone_B:	Title='Prop/&RockTitle', Desc=''
Stone_C:	Title='Prop/&RockTitle', Desc=''
Stone_D:	Title='Prop/&RockTitle', Desc=''
Stone_E:	Title='Prop/&RockTitle', Desc=''
Stone_F:	Title='Prop/&RockTitle', Desc=''
Stool:	Title='Prop/&StoolTitle', Desc=''
Stove:	Title='Prop/&StoveTitle', Desc=''
Strange:	Title='VisualMood/&StrangeTitle', Desc=''
Straw_A:	Title='Prop/&StrawTitle', Desc=''
Straw_B:	Title='Prop/&StrawTitle', Desc=''
Street_Debris_A:	Title='Prop/&DebrisATitle', Desc=''
Street_Debris_B:	Title='Prop/&DebrisATitle', Desc=''
Street_Debris_C:	Title='Prop/&DebrisATitle', Desc=''
Street_Debris_D:	Title='Prop/&DebrisATitle', Desc=''
StreetLampost:	Title='Prop/&StreetLampostTitle', Desc=''
Structure_A:	Title='Prop/&StructureTitle', Desc=''
Structure_B:	Title='Prop/&StructureTitle', Desc=''
Structure_C:	Title='Prop/&StructureTitle', Desc=''
Stump_A:	Title='Prop/&StumpTitle', Desc=''
Stump_B:	Title='Prop/&StumpTitle', Desc=''
Stump_C:	Title='Prop/&StumpTitle', Desc=''
SubtitleTable:	Title='', Desc=''
SuperEgoDragonCombatEndedCompatibilityScenario:	Title='', Desc=''
Swamp:	Title='', Desc=''
SwampHagCombatDecisions:	Title='', Desc=''
Table_A:	Title='Prop/&TableTitle', Desc=''
Table_A_Covered:	Title='Prop/&TableTitle', Desc=''
Table_B:	Title='Prop/&TableTitle', Desc=''
Table_C:	Title='Prop/&TableTitle', Desc=''
Table_D:	Title='Prop/&TableTitle', Desc=''
TableTavern_A:	Title='Prop/&TableTitle', Desc=''
TavernRail_Kit_A:	Title='Prop/&GuardrailsATitle', Desc=''
TavernRailEnd_Kit:	Title='Prop/&GuardrailsATitle', Desc=''
Telema_SecondaryQuest:	Title='Quest/&Telema_SecondaryQuest_Title', Desc=''
TelemaLevel_Quest:	Title='Quest/&TelemaLevel_Title', Desc=''
Telescope_A:	Title='Prop/&TelescopeTitle', Desc=''
Telescope_B:	Title='Prop/&TelescopeTitle', Desc=''
Temple_Of_Einar_Scenario_Act3:	Title='Temple of einar Act 3', Desc=''
Temple_Of_Einar_Scenario_Council_02:	Title='Temple of einar Act 1', Desc=''
TempleOfTheLostGod:	Title='', Desc=''
Tent_A:	Title='Prop/&TentTitle', Desc=''
Tent_B:	Title='Prop/&TentTitle', Desc=''
Tent_C:	Title='Prop/&TentTitle', Desc=''
Tent_D:	Title='Prop/&TentTitle', Desc=''
Tent_E:	Title='Prop/&TentTitle', Desc=''
Tent_F:	Title='Prop/&TentTitle', Desc=''
TestTree:	Title='', Desc=''
TheIDArenaDoorCompatibilityScenario:	Title='', Desc=''
TheIDArenaPressurePlateCompatibilityScenario:	Title='', Desc=''
Thicket_A:	Title='Prop/&ThicketTitle', Desc=''
Thicket_B:	Title='Prop/&ThicketTitle', Desc=''
Thicket_C:	Title='Prop/&ThicketTitle', Desc=''
TigerDrake_Presentation:	Title='', Desc=''
Tirmarian_Tower_Quest:	Title='Quest/&Tirmarian_Tower_Quest_GetStuffTitle', Desc=''
Tombstone_A:	Title='Prop/&TombstoneTitle', Desc=''
Tombstone_B:	Title='Prop/&TombstoneTitle', Desc=''
Tombstone_C:	Title='Prop/&TombstoneTitle', Desc=''
Tombstone_D:	Title='Prop/&TombstoneTitle', Desc=''
TombstonePack_A:	Title='Prop/&TombstonePackTitle', Desc=''
TombstonePack_B:	Title='Prop/&TombstonePackTitle', Desc=''
TombstonePack_C:	Title='Prop/&TombstonePackTitle', Desc=''
TorchPike:	Title='Gadget/&TorchPikeTitle', Desc=''
Totem_A:	Title='Prop/&TotemTitle', Desc=''
Totem_B:	Title='Prop/&TotemTitle', Desc=''
Totem_C:	Title='Prop/&TotemTitle', Desc=''
Tower_Of_Magic_Return_Scenario:	Title='', Desc=''
Tower_Of_Magic_Scenario:	Title='', Desc=''
TowerOfMagic:	Title='', Desc=''
TowerOfMagic_S0_TalkToBeryl:	Title='Campaign/&CrownOfTheMagister_Journal_TOM_0Beryl', Desc=''
TowerOfMagic_S0_TalkToDaliat:	Title='Campaign/&CrownOfTheMagister_Journal_TOM_0Daliat', Desc=''
TowerOfMagic_S0_TalkToRobar:	Title='Campaign/&CrownOfTheMagister_Journal_TOM_0Robar', Desc=''
TowerOfMagic_S1_A_AfterFightingWorkers:	Title='Campaign/&CrownOfTheMagister_Journal_TOM_1_A', Desc=''
TowerOfMagic_S1_A_Outside_Intro:	Title='Campaign/&CrownOfTheMagister_Journal_TOM_1_A_intro', Desc=''
TowerOfMagic_S1_A_Outside_Show_Monster:	Title='', Desc=''
TowerOfMagic_S1_B_ExcavationEntrance_NPC_Talk:	Title='Campaign/&CrownOfTheMagister_Journal_TOM_1_B_LoneWorker', Desc=''
TowerOfMagic_S1_C_ExcavationDepth_Zero_Gravity:	Title='Campaign/&CrownOfTheMagister_Journal_TOM_1_C_FlyingRock', Desc=''
TowerOfMagic_S2_A_Book_Lore:	Title='Campaign/&CrownOfTheMagister_Journal_DialogTitle_CaerLemGeneric', Desc=''
TowerOfMagic_S2_A_DoorOpened:	Title='Campaign/&CrownOfTheMagister_Journal_TOM_2_DoorOpened', Desc=''
TowerOfMagic_S2_A_Intro:	Title='', Desc=''
TowerOfMagic_S2_A_Statue_1:	Title='', Desc=''
TowerOfMagic_S2_A_Statue_1_Explanations:	Title='Campaign/&CrownOfTheMagister_Journal_DialogTitle_CaerLemGeneric', Desc=''
TowerOfMagic_S2_A_Statue_2_Explanations:	Title='Campaign/&CrownOfTheMagister_Journal_DialogTitle_CaerLemGeneric', Desc=''
TowerOfMagic_S2_A_Statue_3_Explanations:	Title='Campaign/&CrownOfTheMagister_Journal_DialogTitle_CaerLemGeneric', Desc=''
TowerOfMagic_S2_A_Unexpected_Column:	Title='Campaign/&CrownOfTheMagister_Journal_TOM_2_RunePuzzle', Desc=''
TowerOfMagic_S2_A_UselessLever:	Title='Campaign/&CrownOfTheMagister_Journal_TOM_2_LockedDoor', Desc=''
TowerOfMagic_S3_A_CrownRoom_Intro_01:	Title='Campaign/&CrownOfTheMagister_Journal_TOM_3_Soraks', Desc=''
TowerOfMagic_S3_A_CrownRoom_ShowMonster_01:	Title='', Desc=''
TowerOfMagic_S3_A_DoorOpened:	Title='', Desc=''
TowerOfMagic_S3_AfterKillingImps:	Title='Campaign/&CrownOfTheMagister_Journal_TOM_3_SoraksDead', Desc=''
TowerOfMagic_S3_TheCrown:	Title='Campaign/&CrownOfTheMagister_Journal_TOM_3_TheCrown', Desc=''
TowerOfMagic_S4_CrownOwned:	Title='Campaign/&CrownOfTheMagister_Journal_TOM_3_TheCurse', Desc=''
TowerOfMagic_S4_ReturnToCaerCyflen:	Title='Campaign/&CrownOfTheMagister_Journal_TOM_3_ReturnToCC', Desc=''
Town:	Title='', Desc=''
Town_Corner_12C:	Title='Room/&Town_Corner_12CTitle', Desc=''
Town_Entrance_24C:	Title='Room/&Town_Entrance_24CTitle', Desc=''
Town_Large_24C:	Title='Room/&Town_Large_24CTitle', Desc=''
Town_Medium_12C:	Title='Room/&Town_Medium_12CTitle', Desc=''
Town_Medium_Exterior_A_12C:	Title='Room/&Town_Exterior_MediumTitle', Desc=''
Town_Medium_Exterior_B_12C:	Title='Room/&Town_Exterior_MediumTitle', Desc=''
Town_Walls_A_12C:	Title='Room/&Town_OuterWalls_MediumTitle', Desc=''
Town_Walls_B_12C:	Title='Room/&Town_OuterWalls_MediumTitle', Desc=''
Town_Walls_C_12C:	Title='Room/&Town_OuterWalls_MediumTitle', Desc=''
Town_Walls_D_12C:	Title='Room/&Town_OuterWalls_MediumTitle', Desc=''
Toxic:	Title='VisualMood/&ToxicTitle', Desc=''
TravelJournal:	Title='', Desc=''
TreasurePedestal:	Title='Prop/&TreasurePedestalTitle', Desc=''
Tree_A:	Title='Prop/&TreeTitle', Desc=''
Tree_B:	Title='Prop/&TreeTitle', Desc=''
Tree_C:	Title='Prop/&TreeTitle', Desc=''
TriggerDefeat:	Title='', Desc=''
Trophy_Wolf:	Title='Prop/&TrophyTitle', Desc=''
Trunk_A:	Title='Prop/&TrunkTitle', Desc=''
Turn_12C:	Title='Room/&Turn_12CTitle', Desc=''
Turn_12C_Organic:	Title='Room/&Turn_12CTitle', Desc=''
TurnUndead:	Title='', Desc=''
Tuto_04_FakeFight:	Title='', Desc=''
Tuto_04_Intro:	Title='', Desc=''
Tutorial_00_Tavern_DateTime_Restore:	Title='', Desc=''
Tutorial_00_Tavern_DateTime_Restore10h30:	Title='', Desc=''
Tutorial_00_Tavern_DateTime_Restore11h00:	Title='', Desc=''
Tutorial_00_Tavern_DateTime_Restore11h30:	Title='', Desc=''
Tutorial_00_Tavern_DateTime_Restore12h00:	Title='', Desc=''
Tutorial_00_Tavern_DateTime_Start:	Title='', Desc=''
Tutorial_01_Contextual_01:	Title='', Desc=''
Tutorial_01_Contextual_02:	Title='', Desc=''
Tutorial_01_Prison_DateTime_Flashback:	Title='', Desc=''
Tutorial_01_Quest:	Title='Quest/&Tutorial_01_Title', Desc=''
Tutorial_02_Alpha_Spawn:	Title='', Desc=''
Tutorial_02_Bridge_Collapse:	Title='', Desc=''
Tutorial_02_Combat_DateTime_Flashback:	Title='', Desc=''
Tutorial_02_Intro:	Title='', Desc=''
Tutorial_02_Quest_Combat:	Title='Quest/&Tutorial_04_Title', Desc=''
Tutorial_03_OrcHideout_DateTime_Flashback:	Title='', Desc=''
Tutorial_03_Quest_OrcHideout:	Title='Quest/&Tutorial_02_Title', Desc=''
Tutorial_03_Secondary_Quest_OrcHideout:	Title='Quest/&Tutorial_02_2_Title', Desc=''
Tutorial_04_Quest_Stealth:	Title='Quest/&Tutorial_03_Title', Desc=''
Tutorial_04_Secondary_Quest:	Title='Quest/&Tutorial_04_Quest_GetKeyMainTitle', Desc=''
Tutorial_04_Stealth_DateTime_Flashback:	Title='', Desc=''
Tutorial_04_Stealth_DateTime_StartCaerLemQuest:	Title='', Desc=''
Tutorial_Scenario:	Title='Tutorial Scenario Started after starting a new campaign', Desc=''
Tutorial_SUB_Scenario_Tutorial_01_Prison:	Title='Tutorial 01 Scenario Started inside the Tavern', Desc=''
Tutorial_SUB_Scenario_Tutorial_02_Combat:	Title='Tutorial Scenario Started after the end of tutorial 01', Desc=''
Tutorial_SUB_Scenario_Tutorial_03_Orc_Hideout:	Title='Tutorial Scenario Started after the end of tutorial 02', Desc=''
Tutorial_SUB_Scenario_Tutorial_04_Stealth:	Title='Tutorial Scenario Started after the end of tutorial 03', Desc=''
Tutorial01_FallingPillar:	Title='', Desc=''
Tutorial03_DrawbridgeOpening:	Title='', Desc=''
Tutorial03_Intro:	Title='', Desc=''
Tutorial03_OrcCamp:	Title='', Desc=''
Tutorial03_OrcsDeparting:	Title='', Desc=''
Tutorial03_OrcTotem:	Title='', Desc=''
TutorialTable:	Title='', Desc=''
TutorialToc:	Title='', Desc=''
Valley:	Title='', Desc=''
VerissaIronshell_PickupQuest:	Title='', Desc=''
Volcano:	Title='', Desc=''
Wall_Destroyed_A:	Title='Prop/&WallDestoyedTitle', Desc=''
Wall_Link:	Title='Prop/&WallLinkTitle', Desc=''
Wall_Simple_A:	Title='Prop/&WallSimpleTitle', Desc=''
Wall_Simple_B:	Title='Prop/&WallSimpleTitle', Desc=''
Wall_Simple_C:	Title='Prop/&WallSimpleTitle', Desc=''
Wall_Simple_D:	Title='Prop/&WallSimpleTitle', Desc=''
Wall_Simple_E:	Title='Prop/&WallSimpleTitle', Desc=''
Wall_Simple_F:	Title='Prop/&WallSimpleTitle', Desc=''
Wall_Simple_G:	Title='Prop/&WallSimpleTitle', Desc=''
Wall_Simple_LowGround_A:	Title='Prop/&WallSimpleTitle', Desc=''
Wall_Thin_Corner_A:	Title='Prop/&WallThinTitle', Desc=''
Wall_Thin_Corner_B:	Title='Prop/&WallThinTitle', Desc=''
Wall_Thin_CornerT:	Title='Prop/&WallThinTitle', Desc=''
Wall_Thin_Link:	Title='Prop/&PrisonFenceTitle', Desc=''
Wall_Thin_Straight_A:	Title='Prop/&WallThinTitle', Desc=''
Wall_Thin_Straight_B:	Title='Prop/&WallThinTitle', Desc=''
WallCastel_A:	Title='Prop/&WallSimpleTitle', Desc=''
WallCastel_B:	Title='Prop/&WallSimpleTitle', Desc=''
WallCastel_Butress_A:	Title='Prop/&WallButressTitle', Desc=''
WallCastel_Butress_B:	Title='Prop/&WallButressTitle', Desc=''
WallCastel_C:	Title='Prop/&WallSimpleTitle', Desc=''
WandererQuestFixSmallCharactersCompatibilityScenario:	Title='WandererQuestFixSmallCharacters', Desc=''
Warm:	Title='VisualMood/&WarmTitle', Desc=''
Waterfall:	Title='', Desc=''
WereBear_Presentation:	Title='', Desc=''
Wight_Lord_Presentation:	Title='', Desc=''
WightCombatDecisions:	Title='', Desc=''
WightLordCombatDecisions:	Title='', Desc=''
Window_A:	Title='Prop/&WindowTitle', Desc=''
Window_B:	Title='Prop/&WindowTitle', Desc=''
Window_C:	Title='Prop/&WindowTitle', Desc=''
Window_D:	Title='Prop/&WindowTitle', Desc=''
WinterWolfCombatDecisions:	Title='', Desc=''
WolfCombatDecisions:	Title='', Desc=''
WoodenFence_Link:	Title='Prop/&PrisonFenceTitle', Desc=''
WoodenFence_Straight_A:	Title='Prop/&PrisonFenceTitle', Desc=''
WoodenFence_Straight_B:	Title='Prop/&PrisonFenceTitle', Desc=''
WoodenPlatform_A:	Title='Prop/&WallSimpleTitle', Desc=''
WoodenPlatform_B:	Title='Prop/&WallSimpleTitle', Desc=''
WoodLog_A:	Title='Prop/&WoodLogTitle', Desc=''
WoodLog_B:	Title='Prop/&WoodLogTitle', Desc=''
WoodLog_C:	Title='Prop/&WoodLogTitle', Desc=''
WoodLog_D:	Title='Prop/&WoodLogTitle', Desc=''
WorkTable_A:	Title='Prop/&WorkTableTitle', Desc=''
WorkTable_B:	Title='Prop/&WorkTableTitle', Desc=''
WorkTable_C:	Title='Prop/&WorkTableTitle', Desc=''
Young_Black_Dragon_Presentation:	Title='', Desc=''
Young_Green_Dragon_Presentation:	Title='', Desc=''
ZombieCombatDecisions:	Title='', Desc=''
